abang|aa
kakak|aa
abad|abad
ayah|abah
bapak|abah
saya|kuring
aku|kuring
aku|abdi
saya|abdi
mengabdi|ngabdi
berbakti|ngabdi
agar|abeh
supaya|abeh
adu|aben
budak|abid
pisau dapur|abir
mentang|abong
berat|abot
beratnya|abotna
masuk|abus
acara|acara
acaranya|acarana
iler|acay
liur|acay
ngiler|ngacay
mengiler|ngacay
sembarang|acak
acak|acak
belum|acan
azan|adan
adegan|adegan
menempel|adek
adik|adi
takabur|adigung
adil|adil
adu|adu
agamanya|agamana
agama|ageman
agung|agung
agustus|agustus
agenda|agenda
ahad|ahad
akhir|ahir
akhirnya|ahirna
ahli|ahli
aneh|aheng
akhirat|aherat
akhlak|ahlak
ajak|ajak
meninggal|ajal
ajakan|ajakan
ajaran|ajaran
bagian|ajang
untuk|ajang
ajak|ajak
belajar|ajar
ajaran|ajar
tegak|ajeg
harga|ajen
nilai|ajen
ulama|ajengan
segan|ajrih
ajudan|ajudan
martabat|ajen
abang|akang
intelektual|akal
benak|akal
jiwa|akal
pikiran|akal
akar|akar
kakek|aki
imbas|akibat
dampak|akibat
kakeknya|akina
aksara|aksara
aksi|aksi
aksinya|aksina
akses|akses
aksesnya|aksesna
aktif|aktip
aktifkan|aktipkeun
menganggap|ngaku
mengaku|ngaku
akur|akur
alam|alam
alamat|alamat
alamatnya|alamatna
karena|alatan
akibat|alatan
album|albeum
alasan|alesan
alasannya|alesanna
alih|alih
sekat|aling
alkohol|alkohol
keponakan|alo
keponakannya|alona
inisiatif|alpukah
gagasan|alpukah
lempar|alung
baik|alus
bagus|alus
baiknya|alusna
aman|aman
amanat|amanat
amanah|amanat
amarah|amarah
berserakan|ambacak
marah|ambek
napas|ambekan
bau|ambeu
amblas|ambles
ambulans|ambulan
agar|ambeh
manis|amis
nyaris|ampir
hampir|ampir
amplop|amplop
mujarab|ampuh
amunisi|amunisi
anak|anak
anakku|anaking
anaknya|anakna
analisis|analisis
pelan|anca
ancaman|anceman
ancamnya|ancemna
tinggal|ancik
cadangan|anco
berkecimpung|ancrub
melonjak-lonjak|ancul-anculan
hancur|ancur
bersimpuh|andeprok
handuk|anduk
tandus|angar
anggapan|anggapan
anggaran|anggaran
tetaplah|angger
anggota|anggota
anggotanya|anggotana
angka|angka
angkatan|angkatan
mendung|angkeub
angklung|angklung
animasi|animasi
anda|anjeun
beliau|anjeunna
anjing|anjing
tiba|anjog
sela|antara
antara|antara
antaranya|antarana
santai|antare
anti|anti
pendiam|antieum
yang|anu
baru|anyar
barunya|anyarna
hafalan|apalan
aparat|aparat
sial|apes
apotik|apotek
apotek|apotek
april|april
arah|arah
arahan|arahan
rintangan|aral
jarang|arang
gagap|arap-ap eureup-eup
aneh-aneh|araraheng
berbelok-belok|arileu
armada|armada
arsip|arsip
arsitek|arsitek
artikel|artikel
arus|arus
arena|arena
matang|asak
sumber|asal
asal|asal
berasal|asalna
asalnya|asalna
ashar|asar
asas|asas
asasi|asasi
kukusan|aseupan
cinta|asih
asin|asin
asing|asing
asli|asli
aslinya|aslina
sodor|asong
aspal|aspal
aspek|aspek
asrama|asrama
asri|asri
makam|astana
masuk|asup
masuknya|asupna
mentah|atah
maupun|atawa
ataupun|atawa
ataukah|atawa
atau|atawa
gatal|ateul
hati-hati|ati-ati
pendidikan|atikan
didikan|atikan
pendidikannya|atikanana
atlet|atlet
suka|atoh
senang|atoh
gembira|atoh
atau|atanapi
tetapi|atanapi
terang jelas|atra
dong|atuh
rambu|aturan
peraturan|aturan
aturan|aturan
ancang-ancang|awahan
tubuh|awak
badan|awak
tubuhnya|awakna
badannya|awakna
permulaan|awal
awal|awal
awalnya|awalna
gema|aweuhan
gaung|aweuhan
jelek|awon
boros|awuntah
acak|awut
berceceran|awer
awet|awet
wanita|awewe
perempuan|awewe
aur|awi
buluh|awi
bambu|awi
tebar|awur
menebarkan|ngawurkeun
terdapat|aya
berada|aya
ada|aya
keberadaan|ayana
adanya|ayana
ayat|ayat
saat ini|ayeuna
kali ini|ayeuna
sekarang|ayeuna
bab|bab
berbagi|babagi
babak|babak
babakan|babakan
berniaga|babalantik
berbisnis|babalantik
bersamaan|babarengan
bersama-sama|babarengan
bersama|babarengan
berbarengan|babarengan
ungkapan|babasan
kepala|babatok
teman-temannya|babaturanana
bacaan|bacaan
berantakan|bacacar
besar|badag
besarnya|badagna
raga|badan
mendarat|badarat
bulu tangkis|badminton
berganti|baganti
bagian|bagian
bahagia|bagja
membangkang|baha
bahan|bahan
dahulu|baheula
dulunya|baheulana
tumpah|bahe
bajigur|bajigur
perampok|bajo
bajakan|bajoan
berjuang|bajoang
baju|baju
bakalan|bakal
bakal|bakal
akan|bakal
akan dapat|bakalan
bakat|bakat
tembakau|bako
berantakan|bakrek
berbakti|bakti
bakti|baktos
bola|bal
dermawan|balabah
musibah|balai
makan-makan|balakecrakan
lengah|balangah
belanja|balanja
masyarakat|balarea
berlayar|balayar
bungkam|balem
balas|bales
balasan|balesan
pulang|balik
kembali|balik
balik|balik
akibatnya|balukarna
balai|bale
lempar|baledog
kekacauan|bancang pakewuh
banding|banding
pembanding|bandingan
cemberut|bangkerut
nakal|bangor
bangsa|bangsa
bank|bank
banting|banting
bantingan|bantingan
bantu|bantu
bantuan|bantuan
banteng|banteng
bapak|bapa
bapaknya|bapana
ayahnya|bapana
berandal|baragajul
benda|barang
barang|barang
saudara|baraya
kerabat|baraya
bareng|bareng
beserta|bareng
bengkak|bareuh
sembari|bari
sambil|bari
basi|bari
akan|baris
anak-anak|barudak
oh|baruk
bentol-bentol|barentol
baret|baret
dahulu|bareto
kala|basa
bahasa|basa
bahasa asing|basa kosta
sederhana|basajan
bahasanya|basana
basah|baseuh
basis|basis
pesisir|basisir
pantai|basisir
basket|basket
baso|baso
batalkan|batalkeun
daripada|batan
batang|batang
tempurung|batok
batu|batu
orang lain|batur
rekan|batur
temannya|baturna
rekannya|baturna
bawa|bawa
bawang|bawang
berceceran|bayabah
bayangkan|bayangkeun
bayarannya|bayaranana
kegerahan|bayeungyang
pembersihan|beberesih
senapan|bedil
senapannya|bedilna
batal|bedo
golok|bedog
bedug|bedug
bedugnya|bedugna
kurus|begang
pubertas|beger
bejat|bejad
bekasi|bekasi
bekal|bekel
utuh|beleger
belut|belut
bendera|bendera
betul|bener
bener|bener
benar|bener
tepatnya|benerna
benarnya|benerna
bentuknya|bentukna
kejar|berik
berkas|berkas
bersih|bersih
kok|bet
betah|betah
banting|beubeut
lembab|beueus
leher|beuheung
semakin|beuki
kian|beuki
makin|beuki
bakar|beuleum
beli|beuli
didapatkan|beunang
berisi|beuneur
beban|beungbeurat
wajah|beungeut
muka|beungeut
wajahnya|beungeutna
kaya|beunghar
siang|beurang
berat|beurat
merah|beureum
tikus|beurit
bus|beus
besi|beusi
perut|beuteung
umbi|beuti
lunak|beye
pidato|biantara
terbiasa|biasa
biasanya|biasana
biayanya|biayana
bibi|bibi
bibinya|bibina
berikan|bikeun
bilateral|bilateral
melengkung|bingkeng
bingung|bingung
benih|binih
bintara|bintara
dapat|bisa
bisa|bisa
bisnis|bisnis
betis|bitis
meletus|bitu
bibir|biwir
blognya|blogna
blok|blok
jangan-jangan|boa-boa
bobol|bobok
bakul|boboko
bocor|bocor
putih|bodas
punya|boga
beraksi|boga aksi
beranak|boga anak
berdurasi|boga durasi
berformat|boga format
berfungsi|boga fungsi
bergelar|boga gelar
berhasrat|boga hasrat
berkesempatan|boga kasempetan
berlisensi|boga lisensi
bermaksud|boga maksud
bermuatan|boga muatan
berniat|boga niat
berpendapat|boga pamadegan
berpengalaman|boga pangalaman
berposisi|boga posisi
berpotensi|boga potensi
berencana|boga rencana
bersalah|boga salah
bersifat|boga sipat
berkarakter|boga sipat
berskala|boga skala
bertata|boga tata
bertujuan|boga tujuan
berujung|boga tungtung
beruntung|boga untung
berwarna|boga warna
miliknya|bogana
bolos|bolos
usulan|bongbolongan
saran|bongbolongan
bungkuk|bongkok
lengah|bongoh
anus|bool
penakut|borangan
bosan|bosen
brigade|brigade
buah|buah
buahnya|buahna
buaya|buaya
pembukaan|bubuka
bocah|budak
budaya|budaya
bangkai|bugang
udel|bujal
pusar|bujal
pantat|bujur
bukti|bukti
buku|buku
bukunya|bukuna
bulan|bulan
bulanan|bulanan
biru|bulao
timbunan|bulenan
bulat|buleud
telanjang|buligir
bumi|bumi
lingkaran|bunderan
bundaran|bunderan
suka cita|bungah
lega|bungangang
delta|bungin
bungkam|bungkem
bungkus|bungkus
bungkusnya|bungkusna
bungsu|bungsu
ungu|bungur
ekor|buntut
membara|burahay
beringas|buringas
sore|burit
pelarian|buronan
pelariannya|buronanna
cepat-cepat|buru-buru
buruh|buruh
berudu|buruy
kusut|busik
raksasa|buta
butek|butek
rambut|buuk
habis|beak
habiskan|beakkeun
pera|bear
beras|beas
bebas|bebas
habis-habisan|bebeakan
becek|becek
perbedaan|beda
berbeda|beda
beda|beda
perbedaannya|bedana
bedanya|bedana
rampok|begal
pemberitahuan|beja
kabar|beja
kabarnya|bejana
pertahankan|bela
bengkok|bengkok
bintang|bentang
fasih|bentes
pupuk|berak
beri|bere
beres|beres
pengumuman|bewara
banjir|caah
banjir bandang|caah rongkah
terang|caang
cabang|cabang
cabai|cabe
cacat|cacad
walau|cacak
meski|cacak
sehat|cageur
kehormatan|cahara
cahaya|cahya
air|cai
berair|caian
cerdas|calakan
celana|calana
korupsi|calikong
kandidat|calon
calon|calon
tembem|cambepem
campur|campur
campuran|campuran
tersisa|cangkaruk
pegal|cangkeul
pinggang|cangkeng
lelah|cape
cara|cara
caranya|carana
kerangka|carangka
geraham|careham
berlepotan|caremot
kisah|carita
cerita|carita
catatan|catetan
pisang|cau
porno|cawokah
hambar|cawerang
pegangan|cecekelan
kikir|cedit
terangnya|cenah
katanya|cenah
ujarnya|cenahna
genit|centil
benci|ceuceub
terbahak-bahak|ceuceuleukeuteukan
berteriak|ceuceuleuweungan
mendung|ceudeum
ujar|ceuk
tutur|ceuk
menurutnya|ceuk manehna
telinga|ceuli
kuping|ceuli
telinganya|ceulina
tangis|ceurik
menangis|ceurik
nangis|ceurik
diam|cicing
ludah|ciduh
sulung|cikal
kencur|cikur
barusan|cikeneh
baru saja|cikeneh
lengah|cileureun
kelingking|cingir
jongkok|cingogo
cintai|cinta
cinta|cinta
sumber air|cinyusu
mata air|cinyusu
airmatanya|cipanonna
cipta|cipta
ceriwis|ciriwis
cetak|citak
cetakan|citakan
cetaknya|citakna
coba|coba
sreg|cocog
cocok|cocog
coklat|coklat
ambil|cokot
cungkil|cokel
colok|colok
cenderung|condong
contoh|conto
sebagai contoh|contona
misalnya|contona
contohnya|contona
copot|coplok
benci|cua
anak|cucu
duri|cucuk
penyebab|cukang lantaran
cukuplah|cukup
cukup|cukup
culik|culik
telunjuk|curuk
sirip|cecepet
cek|cek
percik|ceret
cerewet|cerewet
sih|da
dagang|dagang
dagangan|dagangan
tergesa-gesa|dagdegdog
daging|daging
makan|dahar
dahlia|dahlia
delapan|dalapan
berdelapan|dalapanan
sempoyongan|dalugdag-daligdeg
damar|damar
bekerjanya|damelna
pipi|damis
dana|dana
tengadah|dangah
mendongak|dangah
berdandan|dangdan
dedaunan|dangdaunan
dangdut|dangdut
sikap|dangong
daftar|daptar
darat|darat
daratan|daratan
berdatangan|daratang
ramah|darehdeh
dasar|dasar
dasarnya|dasarna
data|data
data-datanya|data-datana
datang|datang
kunjungi|datangan
kunjungan|datangna
kehadirannya|datangna
kedatangan|datangna
datangnya|datangna
biasa|dawam
sikap|daweung
abu-abu|dawuk
kota|dayeuh
mau|daek
bersedia|daek
daerah|daerah
dedak|dedek
berlutut|deku
delegasi|delegasi
demi|demi
tersembunyi|demit
demokratis|demokratis
pesek|demes
mendekam|depa
desain|desain
desainnya|desainna
detik|detik
terulang kembali|deudeuieun
berulang-ulang|deudeuieun
ulang|deui
lagi|deui
dekat|deukeut
asing|deungeun
di|di
berikut ini|di handap ieu
di bawah|di handapeun
di dalam|di jero
di dalamnya|di jerona
dimana-mana|di mamana
dimana|di mana
keberadaannya|di mana ayana
dimasuki|diabusan
diacungi|diacungan
diadili|diadilan
diadopsi|diadopsi
beradu|diadu
diagram|diagram
diajak|diajak
belajar|diajar
diaktifkan|diaktifkeun
diakuinya|diaku
diakui|diaku
dialami|dialaman
dilontarkan|dialungkeun
dilemparkan|dialungkeun
dianggap|dianggap
dianggarkan|dianggarkeun
diangkat|diangkat
diantaranya|diantarana
dianut|dianut
diterbangkan|diapungkeun
diarahkan|diarahkeun
diartikan|diartikeun
diasosiasikan|diasosiasikeun
dimasukkan|diasupkeun
dijebloskan|diasupkeun
diatur|diatur
ditebarkan|diawurkeun
diselenggarakan|diayakeun
diadakan|diayakeun
diadakannya|diayakeunana
diperbantukan|dibabantukeun
dibaca|dibaca
didiskusikan|dibadamikeun
dibagi|dibagi
dibagikan|dibagikeun
dibahas|dibahas
dibajak|dibajo
dibakukan|dibakukeun
diakibatkan|dibalukarkeun
dibandingkan|dibandingkeun
dibanding|dibandingkeun
dibantu|dibantuan
disertai|dibarengan
disertai|dibarung
ditemani|dibaturan
dibawa|dibawa
dikuras|dibedahkeun
diperbaiki|dibenerkeun
dikoreksi|dibenerkeun
dibenarkan|dibenerkeun
dibersihkan|dibersihkeun
dipanggang|dibeuleum
dibeli|dibeuli
dibebani|dibeungbeuratan
dibiasakan|dibiasakeun
diserahkan|dibikeun
diberikan|dibikeun
dimusnahkan|dibinasakeun
disertai|dibiruyungan
diboncengi|diboncengan
dibuktikan|dibuktikeun
dibungkus|dibungkus
dibeda-bedakan|dibeda-bedakeun
dibedakan|dibedakeun
diberitahukan|dibejakeun
dikasih|dibere
diberi|dibere
diberitahu|dibere nyaho
dicampur|dicampur
dicatat|dicatet
dicatatkan|dicatetkeun
dipegang|dicekel
diserukan|dicelukkeun
dikecam|dicempad
dituangkan|dicicikeun
dicicil|dicicil
dihuni|dicicingan
berpenghuni|dicicingan
ditentukan|dicindekkeun
diciptakan|diciptakeun
diciptakannya|diciptakeunana
dicoba|dicoba
diambil|dicokot
dimainkan|dicoo
dicopot|dicoplok
disalin|dicutat
dipaparkan|didadarkeun
dikunjungi|didatangan
didesak|didesek
didekati|dideukeutan]]
sinilah|dieu
sini|dieu
dihentikan|dieureunkeun
diberhentikan|dieureunkeun
diisi|dieusi
digelorakan|digalurakeun
dibalas|diganjar
diganti|digantian
digantikan|digantikeun
digantung|digantung
ditampari|digaplokan
dikeringkan|digaringkeun
bekerja|digawe
bekerja sama|digawe babarengan
diremas-remas|digecek
diperbesar|digedean
dikerumuni|digembrong
digerebeg|digerebeg
dipanggil|digeroan
digiling|digiling
digital|digital
digonggongi|digogogan
digoreng|digoreng
digulingkan|digulingkeun
digeser-geser|digeser-geser
dihadiri|dihadiran
diharapkan|diharepkeun
dihasilkan|dihasilkeun
didahulukan|diheulakeun
disatukan|dihijikeun
diraih|dihontal
dicapai|dihontal
disuapi|dihuapan
dihubungi|dihubungan
digugah|dihudang
dihukum|dihukum
diinjak|diidek
diperkenankan|diidinan
diizinkan|diidinan
diingat|diinget
diingatkan|diingetan
dibiarkan|diingkeun
dipinjam|diinjeum
diperhitungkan|diitung
dihitung|diitung
dibilang|diitung
disita|dijabel
dijadikan|dijadikeun
dijadikan-nya|dijadikeun-Na
diunggulkan|dijagokeun
dijalankan|dijalankeun
dijangjikan|dijangjian
dijelaskan|dijelaskeun
dijemput|dijemput
terbuat|dijieun
dibuat|dijieun
dibentuk|dijieun
dijual|dijual
berjudul|dijudulan
dijunjung|dijungjung
dikendalikan|dikadalikeun
dihadiahi|dikadoan
dikaitkan|dikaitkeun
dikerahkan|dikaluarkeun
dikeluarkan|dikaluarkeun
dikemanakan|dikamanakeun
dikantongi|dikantongan
dijahit|dikaput
dikuasai|dikawasa
dikuasainya|dikawasana
diutarakan|dikedalkeun
diliputi|dikeputan
dipeluk|dikeukeup
dikirim|dikirim
dikirimkan|dikirimkeun
diklat|diklat
diolah|dikokolakeun
dikelola|dikokolakeun
dikompilasi|dikompilasi
dikontrak|dikontrak
dikontrakkan|dikontrakkeun
dikoordinasikan|dikoordinasikeun
dikorek-korek|dikorek-korek
dikosongkan|dikosongkeun
diangkut|dikunjal
dibidik|dikeceng
dilakoni|dilakonan
dilaksanakan|dilaksanakeun
digelar|dilaksanakeun
direalisasikannya|dilaksanakeunana
dilancarkan|dilancarkeun
dilapisi|dilapisan
dilaporkan|dilaporkeun
diadukan|dilaporkeun
dilarang|dilarang
diterapkan|dilarapkeun
dilayani|dilayanan
diluruskan|dilelempeng
dilengkapi|dilengkepan
dilepas|dileupas
dibebaskan|dileupaskeun
dilalui|diliwatan
dihadiran|diluuhan
dilangkahi|dilengkahan
dimanfaatkan|dimangpaatkeun
dimenangkan|dimeunangkeun
dimulai|dimimitian
diawali|dimimitian
bermula|dimimitian
dimodifikasi|dimodifikasi
pada|dina
dalam|dina
dalam rangka|dina raraga
dinamis|dinamis
dinas|dines
dinamakan|dingaranan
situlah|dinya
situ|dinya
dinyatakan|dinyatakeun
dituturkan|diomongkeun
dibicarakan|diomongkeun
diundang|diondang
dilimpahkan|dioperkeun
diguncang|dioyag
dipagar|dipager
dipagari|dipageran
dipahami|dipahaman
dipergunakan|dipake
dipakai|dipake
digunakan|dipake
digunakannya|dipakena
dipengaruhi|dipangaruhan
ditemui|dipanggihan
disampaikannya|dipangnepikeun
dibuatkan|dipangnyieunkeun
disambut|dipapag
dinasehati|dipapagahan
dihiasi|dipapaesan
diperebutkan|diparebutkeun
diperiksa|dipariksa
diparkir|diparkir
dipasang|dipasang
dipastikan|dipastikeun
diterbitkan|dipedar
diputuskan|dipegatkeun
disekat|dipenggel
dipenjara|dipenjara
dipercayai|dipercaya
diperlukan|diperlukeun
dibutuhkan|diperlukeun
dinilai|dipeunteun
dipecahkan|dipeupeuskeun
didapat|dipibanda
dimiliki|dipiboga
dibuang|dipiceun
dilakukan|dipigawe
dikerjakan|dipigawe
dilakukannya|dipigawe ku manehna
terhormat|dipihormat
dihormati|dipihormat
diketahui|dipikanyaho
dikenali|dipikawanoh
dikenal|dipikawanoh
dipikir|dipikir
dipilih|dipilih
dipilihnya|dipilihna
dialihkan|dipindahkeun
dipimpin|dipingpin
dipimpinnya|dipingpinna
diperlihatkan|dipintonkeun
dipenuhi|dipinuhan
diiringi|dipirig
diproduksi|diproduksi
diproses|diproses
diprotes|diprotes
disanjung|dipuji
dikembalikan|dipulangkeun
dipelihara|dipulasara
diusung|dipunggu
diselesaikan|dipungkas
diakhiri|dipungkas
diketuai|dipupuhuan
dipusatkan|dipuseurkeun
diminta|dipenta
dibongkar|dirakrak
dirancang|dirarancang
dirawat|dirawat
direbut|direbut
disimak|diregepkeun
diresmikan|diresmikeun
diri|diri
dirinya|dirina
diubah|dirobah
didukung|dirojong
dirombak|dirombak
ditingkatkan|dironjatkeun
diremajakan|dirumajakeun
dirumuskan|dirumuskeun
dirahasiakan|dirusiahkeun
direktur|direktur
didampingi|direndengan
disediakan|disadiakeun
disahkan|disahkeun
diumumkan|disalabarkeun
diselamatkan|disalametkeun
disalurkan|disalurkeun
disesuaikan|disaluyukeun
disamaratakan|disamarutkeun
disempurnakan|disampurnakeun
dihadapi|disanghareupan
ditengarai|disangka
diduga|disangka
saya kira|disangka ku kuring
disangkanya|disangkana
disamakan|disaruakeun
disetujui|disatujuan
diperdebatkan|disawalakeun
disebarkan|disebarkeun
disebut|disebut
disebut-sebut|disebut-sebut
disebutkan|disebutkeun
dikatakan|disebutkeun
disebutnya|disebutna
disembah|disembah
diserap|diserep
disengat|diseureud
disiapkan|disiapkeun
dipersiapkan|disiapkeun
disiplin|disiplin
diskriminasi|diskriminasi
disponsori|disponsoran
disuguhi|disuguhan
disembunyikan|disumputkeun
disurati|disuratan
didorong|disurungkeun
ditelusuri|disusud
disusul|disusul
disusun|disusun
disisakan|disesakeun
disewakan|disewakeun
ditagih|ditagih
ditahan|ditahan
dipukul|ditakol
dipukuli|ditakolan
ditaklukkan|ditalukkeun
diteliti|ditalungtik
diselidiki|ditalungtik
ditambah|ditambah
ditambahkan|ditambahkeun
ditambal|ditambal
ditolak|ditampik
ditandai|ditandaan
ditandatangani|ditandatanganan
ditanggung|ditanggung
dilindungi|ditangtayungan
ditentukan|ditangtukeun
ditandaskan|ditanjeurkeun
ditanya|ditanya
ditanyakan|ditanyakeun
ditafsirkan|ditapsirkeun
diterima|ditarima
diterjemahkan|ditarjamahkeun
ditanyai|ditaros
diusahakan|ditarekahan
diupayakan|ditarekahan
dipertanyakan|ditatanyakeun
ditawari|ditawaran
ditawarkan|ditawarkeun
dinaikkan|ditaekkeun
ditelpon|ditelepon
ditelepon|ditelepon
ditunjukkan|ditembrakkeun
ditembus|ditembus
ditempati|ditempatan
ditempatkan|ditempatkeun
dipandang|ditempo
dilihat|ditempo
disampaikan|ditepikeun
dijumpai|ditepungan
diteruskan|diteruskeun
ditetapkan|ditetepkeun
ditimpakannya|ditibankeunana
ditinggalkan|ditinggalkeun
ditinggalkannya|ditinggalkeun ku manehna
dikepung|ditingker
disuruh|dititah
sana|ditu
ditugaskan|ditugaskeun
ditukar|ditukeur
tertulis|ditulis
ditulis|ditulis
dituliskan|dituliskeun
dilanjutkan|dituluykeun
dikendarai|ditumpakan
ditumpas|ditumpes
diberantas|ditumpes
disimpan|ditunda
diatasi|ditungkulan
diakhiri|ditungtungan
dituntut|ditungtut
ditunjuk|ditunjuk
diturunkan|diturunkeun
ditutup|ditutup
ditutupi|ditutupan
diikuti|dituturkeun
dicari|diteang
ditembak|ditembak
dijawab|ditembalan
ditempel|ditempel
diteror|diteror
dites|dites
ditangkap|ditewak
dibekuk|ditewak
dikejar|diudag
dikejar-kejar|diudag-udag
duduk|diuk
diungkapkan|diungkabkeun
dikemukakan|diungkabkeun
ditanggulangi|diungkulan
diutus|diutus
diwajibkan|diwajibkeun
diwakili|diwakilan
terdiri|diwangun
dibangun|diwangun
dibentuknya|diwangunna
diperkenalkan|diwanohkeun
diwarnai|diwarnaan
diwaspadai|diwaspadaan
dibatasi|diwatesan
dipoligami|diwayuh
dipilah-pilah|diwilah-wilah
ditumbuhi|diwuwuhan
diekstradisi|diekstradisi
dikalahkan|dielehkeun
dicanangkanlah|diembarkeun
dicanangkan|diembarkeun
ganda|dobel
doktor|doktor
doktrin|doktrin
dokumen|dokumen
dokumentasi|dokumentasi
domain|domain
domba|domba
membungkuk|dongko
durhaka|doraka
dosa|dosa
miring|doyong
dua|dua
duasetengah|dua satengah
dua-pertiga|dua-pertilu
berdua|duaan
keduanya|duanana
kedua-duanya|duanana
dua-duanya|duanana
dubur|dubur
bersaudara|duduluran
kasar|dugal
uang|duit
duit|duit
duitnya|duitna
dukung|dukung
tiba-tiba|dumadakan
mendadak|dumadakan
didasari|dumasar
berdasarkan|dumasar
berdasar|dumasar
dilandasi|dumasar kana
dunia|dunya
duplikat|duplikat
bakar|duruk
kampung|dusun
duta|duta
dekade|dekadeu
demografi|demografi
demokrasi|demokrasi
demokrat|demokrat
dengar|denge
dengarkan|dengekeun
depot|depot
desa|desa
desember|desember
devisa|devisa
dewa|dewa
dewan|dewan
dangkal|deet
emas|emas
ubun-ubun|embun-embunan
kambing|embe
telur|endog
kol|engkol
nanti|engke
nantinya|engkena
nol|enol
ya|enya
betul-betul|enyaan
rem|erem
memar|eumeur
cermin|eunteung
hinggap|eunteup
umpan|eupan
berhentilah|eureun
berhenti|eureun
hentikan|eureunkeun
penghentian|eureunna
isi|eusi
[[isinya]|eusina
berisi|eusina
tidak ada|euweuh
tiada|euweuh
evakuasi|evakuasi
fakultas|fakultas
fasilitasnya|fasilitasna
fatwa|fatwa
firman-nya|firman-Na
fisik|fisik
fluorida|fluorida
forum|forum
fraksinya|fraksina
fundamental|fundamental
mandul|gabug
gabungan|gabungan
gading|gading
dagu|gado
gagal|gagal
substitusi|gaganti
pengganti|gaganti
penggantinya|gagantina
keramik|gagarabah
gaib|gaib
gajah|gajah
gelagat|galagat
pematang|galengan
ikal|galing
bercampur|galo
gelora|galura
galeri|galeri
gambar|gambar
kesan|gambaran
rakus|gambuhang
mudah|gampang
gampang|gampang
mudahnya|gampangna
nenas|ganas
kencang|gancang
cepat|gancang
gendong|gandong
gangguan|gangguan
selisih|ganjor
selisihnya|ganjorna
galah|gantar
ganti|ganti
gantinya|gantina
geledah|garadah
rusak|garah
gratis|garatis
berantem|garelut
kasar|garihal
kering|garing
gas|gas
gasnya|gasna
tebing|gawir
kerja|gawe
kerjasama|gawe babarengan
kerja sama|gawe babarengan
perbuatan|gawena
gaya|gaya
gebrak|gebrag
pepaya|gedang
seri|gedeg
gedung|gedong
gedung-gedung|gedong-gedong
besar-besaran|gegedean
gelar|gelar
gelas|gelas
gerutu|gelendeng
utuh|gembleng
hemat|gemi
pelicin|gemuk
enam|genep
berenam|genepan
tenggorokan|genggerong
pipih|gepeng
penasaran|geremet
sakit|gering
getaran|geter
darah|getih
berdarah|getihan
rajin|getol
jelita|geulis
cantik|geulis
cantik jelita|geulis kawanti-wanti
membiru|geuneuk
lebam|geuneuk
heboh|geunjleung
kenyal|geunyal
segera|geura-giru
telah|geus
sudah|geus
getah|geutah
cepatlah|geuwat
samping|gigireun / sabeulah
sebelahnya|gigireunana
gizi|giji
giling|giling
diganjar|ginanjar
ginseng|ginseng
gitar|gitar
melenceng|giwar
gonggongan|gogog
terguling-guling|gogolencengan
kalangan|golongan
gelinding|gorolong
teriak|gorowok
goreng|goreng
buruk|goreng
gorengnya|gorengna
granat|granat
grup|grup
penjelasan|guaran
gubernur|gubernur
gudang|gudang
kumur|gugurah
heboh|gujrud
gula|gula
gulat|gulat
berayun|gulawing
petir|guludug
halilintar|guludug
tergantung|gumantung
senang hati|gumbira
senang|gumbira
gunanya|gunana
bergantian|gunta-ganti
gunung|gunung
selat|gupitan
garis|gurat
terjal|gurawes
gelinjang|gurinjal
guru|guru
tidur-tiduran|gegelehean
gila|gelo
jenis kelamin|gender
gender|gender
geologi|geologi
geser|geser
geli|getek
hadir|hadir
hendaknya|hadena
momok|hahalang
membentak-bentak|hahaok
hajat|hajat
haji|haji
hak|hak
hakim|hakim
ihwal|hal
hal|hal
halangi|halangan
mendung|haleungheum
merdu|halimpu
kabut|halimun
alis|halis
kemarau|halodo
alu|halu
ragu-ragu|hamham
ringan|hampang
ampas|hampas
empedu|hamperu
maaf|hampura
bawah|handap
hangat|haneut
kehangatan|haneutna
pesing|hangseur
menyesal|hanjakal
sayangnya|hanjakalna
sedih|hanjelu
kecewanya|hanjeluna
gratis|haratis
harapan|harepan
harapkan|harepkeun
gerah|hareudang
depan|hareup
depannya|hareupeunana
harga|harga
harganya|hargana
dada|harigu
senandung|hariring
khawatir|hariwang
harta|harta
makna|harti
arti|harti
berarti|hartina
artinya|hartina
berarti|hartosna
khas|has
khazanah|hasanah
asap|haseup
khasiatnya|hasiatna
hasil|hasil
hasilnya|hasilna
atap|hateup
terima kasih|hatur nuhun
hati|hate
udara|hawa
hawa|hawa
sayup-sayup|hawar-hawar
ayam|hayam
pingin|hayang
pengen|hayang
ingin|hayang
inginkan|hayang
menginginkan|hayangeun
ayo|hayu
mari|hayu
tidak|henteu
enggak|henteu
herbivora|herbivora
heroik|heroik
menguap|heuay
sempit|heureut
ketat|heureut
sempitnya|heureutna
berkibarnya|hibarna
terbang|hiber
hiburan|hiburan
hitam|hideung
ringkik|hiem
suatu|hiji
sebuah|hiji
satu|hiji
sesuatu|hiji hal
seseorang|hiji jalma
satu-satunya|hiji-hijina
satuan|hijian
hikmah|hikmah
ulat|hileud
sepoi-sepoi|hiliwir
sepoi|hiliwir
sembilu|hinis
empuk|hipu
hidup|hirup
hidupnya|hirupna
kentut|hitut
berbantah|hoghag
honor|honor
jangkauan|hontalan
jangkauannya|hontalanana
bengong|hookeun
hormat|hormat
hotel|hotel
rotan|hoe
hubungan|hubungan
hubungannya|hubunganana
hujan|hujan
hukum|hukum
sanksi|hukuman
hukuman|hukuman
mengeluh|humandeuar
gigi|huntu
udang|hurang
bakar|huru
huruf|hurup
khusus|husus
khususnya|hususna
hebat|hebat
hijau|hejo
hektare|hektar
siul|heot
bening|herang
susah|hese
sulit|hese
susahnya|hesena
sulitnya|hesena
malas|hoream
embun|ibun
ide|ideu
izin|idin
ijin|idin
ideal|ideal
identik|identik
ideologi|ideologi
ini|ieu
inilah|ieu pisan
ini adalah|ieu teh
ilmiah|ilmiah
rumah|imah
rumahku|imah kuring
rumahnya|imahna
iman|iman
berimanlah|iman
impor|impor
imunisasi|imunisasi
tersenyum|imut
cucu|incu
pergi|indit
bertolak|indit
berangkat|indit
bepergian|indit-inditan
bunda|indung
ibunya|indungna
industri|industri
indeks|indeks
info|info
informasi|informasi
ingat|inget
berguncang|inggeung
biarkan|ingkeun
ternak|ingon-ingon
pinjam|injeum
injil|injil
tokoh|inohong
inovasi|inovasi
inspektur|inspektur
instruktur|instruktur
intelijen|intelijen
interior|interior
internasional|internasional
internet|internet
intinya|intina
minum|inum
minuman|inuman
minumannya|inumanana
tipis|ipis
tipisnya|ipisna
kapan|iraha
hidung|irung
isya|isa
geser|iser
islam|islam
israel|israel
istilah|istilah
istimewa|istimiwa
mendatang|isuk
keesokan|isuk
besok|isuk
pagi-pagi|isuk-isuk
pagi|isuk-isuk
besok|isukan
tongkat|iteuk
hitung|itung
perhitungan|itungan
kecuali|iwal
jabatannya|jabatanna
menjadi|jadi
jadi|jadi
mengering|jadi garing
jadwal|jadwal
kelak|jaga
jagat|jagat
jago|jago
jahil|jail
jajahan|jajahan
baris|jajar
jajaran|jajaran
jalan|jalan
jalani|jalanan
jalankan|jalankeun
jelantah|jalantah
tomboy|jalingkak
ingkar|jalir
orang|jalma
orang-orangnya|jalma-jalmana
jantan|jalu
jam|jam
jemaah|jamaah
jamaah|jamaah
zaman|jaman
jambu|jambu
jaminan|jaminan
jampi|jampe
jamu|jamu
jendela|jandela
sayap|jangjang
janji|jangji
berjanji|jangji
perjanjian|jangji-pasini
jangkung|jangkung
tingginya|jangkungna
ketinggian|jangkungna
januari|januari
merpati|japati
kuman|jaram
jasa|jasa
jauhnya|jauhna
jawab|jawab
penyelesaiannya|jawabanana
pendekar|jawara
juara|jawara
jaya|jaya
cibir|jebi
kaku|jeger
kaya|jegud
subjek|jejer
kedalaman|jejero
terang-terangan|jelas
orangnya|jelemana
jenderal|jenderal
kaku|jengker
jenis|jenis
jeniusnya|jeniusna
dalam|jero
dalam negeri|jero nagara
malam hari|jero peuting
dalamnya|jerona
jeruk|jeruk
jeruknya|jerukna
jibril|jibril
buatan|jieunan
bentukan|jieunan
mirip|jiga
kayak|jiga
sepertinya|jigana
kemungkinan|jigana
kayaknya|jigana
ada kemungkinan|jigana
jiwa|jiwa
jiwanya|jiwana
jewer|jiwir
dingklik|jojodog
angkasa|jomantara
teriakin|jorowokan
jual|jual
judi|judi
terus terang|jujur
jujur|jujur
rumput|jukut
berumput|jukutan
juli|juli
jumat|jumaah
jumatan|jumaahan
jumlah|jumlah
jumlahnya|jumlahna
kelompok|jumplukan
juni|juni
berhasil|junun
juragan|juragan
hantu|jurig
jurnal|jurnal
juru|juru
pengemudinya|jurumudina
jurusan|jurusan
juta|juta
jutaan|jutaan
jendral|jendral
terhadap|ka
kepada|ka
ke|ka
pada diri|ka diri
kemanapun|ka mana oge
keadilan|kaadilan
keagamaan|kaagamaan
kepiawaian|kaahlian
dialaminya|kaalaman ku manehna
keamanan|kaamanan
keamanannya|kaamananana
kemarahan|kaambek
tertahan|kaampeuh
terancam|kaancam
keanggotaan|kaanggotaan
keanehan|kaanehan
kasih|kaasih
termasuk|kaasup
kemasukan|kaasupan
suasana|kaayaan
situasi|kaayaan
kondisi|kaayaan
keadaan|kaayaan
terbagi|kabagi
kebahagiaan|kabagjaan
kebangsaan|kabangsaan
terbawa|kabawa
kebaya|kabaya
terbayang|kabayang
kabel|kabel
terbentuk|kabentuk
kebersihan|kaberesihan
tertarik|kabetot
terpanggang|kabeuleum
terbakar|kabeuleum
keberatan|kabeuratan
kebiasaan|kabiasaan
keterlaluan|kabina-bina
kabinet|kabinet
terwujud|kabiruyungan
pacar|kabogoh
kekasih|kabogoh
pacarnya|kabogohna
terbongkar|kabongkar
kebudayaan|kabudayaan
terbuka|kabuka
terbukti|kabuktian
kabupaten|kabupaten
kabur|kabur
kebebasan|kabebasan
semua|kabeh
semuanya|kabehanana
kecamatan|kacamatan
tercatat|kacatet
terkenal|kaceluk
diperbolehkan|kaci
dibolehkan|kaci
boleh|kaci
tertuang|kacicikeun
kecelakaan|kacilakaan
kesimpulan|kacindekan
kesimpulannya|kacindekanana
makanan|kadaharan
kendali|kadali
terdaftar|kadaptar
kedatangan|kadatangan
kedatangannya|kadatanganana
kedaulatan|kadaulatan
kader|kader
belakangan ini|kadieunakeun
hadiah|kado
hadiahnya|kadona
durian|kadu
kedua|kadua
menyesal|kaduhung
keuangan|kaduitan
keuangannya|kaduitanana
terlunta-lunta|kadungsang-dungsang
tersenggol|kadupak
awas|kade
terdengar|kadenge
terhenti|kaeureunkeun
terkandung|kaeusi
terisi|kaeusi
tergabung|kagabung
kegagalan|kagagalan
terganggu|kagamah
tergambarkan|kagambarkeun
terganggu|kaganggu
kecantikan|kageulisan
kegiatan|kagiatan
kegiatannya|kagiatanana
aktivitasnya|kagiatanana
terlanjur|kagok
telanjur|kagok
ketergantungan|kagumantungan
ketergantungannya|kagumantunganana
kehakiman|kahakiman
terhambat|kahalangan
kesedihan|kahanjelu
kecemasan|kahariwang
keinginan|kahayang
keinginannya|kahayangna
pertama|kahiji
pertamanya|kahijina
kekhilafan|kahilapan
kehidupan|kahirupan
kehidupannya|kahirupanana
terjangkau|kahontal
tercapai|kahontal
keengganan|kahoream
ternama|kahot
keluhan|kahumandeuar
kesulitan|kahese
kayu|kai
teringat|kainget
kaitan|kaitan
kaitannya|kaitanana
terbilang|kaitung
kecuali|kajaba
peristiwa|kajadian
kejadian|kajadian
terjaga|kajaga
kejaksaan|kajaksaan
kelapangan|kajembaran
biar|kajeun
kekuasaan|kakawasaan
kekayaan|kakayaan
kekejaman|kakejeman
tergenang|kakeueum
terendam|kakeueum
terkena|kakeunaan
tergenggam|kakeupeul
terkenal|kakoncara
canggung|kaku
kekuatan|kakuatan
kekeluargaan|kakulawargaan
terangkut|kakunjal
kekurangan|kakurangan
kelahiran|kalahiran
malah|kalahka
ulah|kalakuan
kelonggaran|kalaluasaan
bayang-bayang|kalangkang
ketertiban|kalantipan
kelapa|kalapa
kelaparan|kalaparan
terlatih|kalatih
dengan|kalawan
terlayani|kalayanan
berlebihan|kaleuleuwihan
kehilangan|kaleungitan
kelebihan|kaleuwihan
kelebihannya|kaleuwihanana
kaliber|kaliber
terlibat|kalibet
kelima|kalima
kalimat|kalimah
kalimat-nya|kalimah-Na
pangling|kalinglap
keliru|kaliru
lalu|kaliwat
sebagian besar|kalolobaan
keluar|kaluar
kesal|kaluman
kedudukan|kalungguhan
jabatan|kalungguhan
kelurahan|kalurahan
utara|kaler
kemahiran|kamaheran
kemajuan|kamajuan
kemakmuran|kamakmuran
selokan|kamalir
kemandirian|kamandirian
keraguan|kamangmang
kemanusiaan|kamanusaan
kamar|kamar
kemaren|kamari
kemarin|kamari
kemasyarakatan|kamasarakatan
kemekaran|kamekaran
kemerdekaan|kamerdikaan
kemenangan|kameunang
kami|kami
kemiliteran|kamiliteran
kemiskinan|kamiskinan
kampung|kampung
kampus|kampus
kemudi|kamudi
kamera|kamera
atas terjadinya|kana kajadian
kenabian|kanabian
kenegaraan|kanagaraan
peningkatan|kanaekan
kenaikan|kanaekan
kambuh|kanceuh
tebal|kandel
tebalnya|kandelna
aniaya|kaniaya
kantong|kantong
kantor|kantor
pengetahuan|kanyaho
ketahuan|kanyahoan
kenyataan|kanyataan
keempat|kaopat
keotentikan|kaotentikan
ditipu|kapacikeuh
kepedulian|kapadulian
terpaksa|kapaksa
berguna|kapake
kapal|kapal
kepemimpinan|kapamingpinan
kedapatan|kapanggih
ditemukan|kapanggih
ditemukannya|kapanggihna
ketuhanan|kapangeranan
kepastian|kapastian
terputus|kapegatkeun
kepentingan|kapentingan
kepercayaan|kapercayaan
keperluan|kaperluan
kebutuhan|kaperluan
keperluannya|kaperluanana
pingsan|kapidara
terpikir|kapikir
terpikirkan|kapikirkeun
kepemilikan|kapimilik
terpenuhi|kapinuhan
keunggulan|kapinunjulan
jera|kapok
kapten|kapten
kepolisian|kapulisian
kepulauan|kapuloan
jahit|kaput
keputusan|kaputusan
dirundung|kapuuk
tergila-gila|kapengpeongan
keracunan|karacunan
kesejahteraan|karaharjaan
kerajaan|karajaan
bernyanyi-nyanyi|karakawihan
bernyanyi|kakawihan
penyamun|karaman
terasa|karasaeun
karat|karat
korosi|karatan
istana|karaton
istananya|karatonna
kusut|karijut
keranjang|karinjang
karir|karir
kartu|kartu
leluhur|karuhun
kerusakan|karuksakan
karusakan|karuksakan
kerusakannya|karuksakanana
selendang|karembong
karet|karet
kereta|kareta
karetnya|karetna
kesadaran|kasadaran
kesalahan|kasalahan
keselamatannya|kasalamatenana
keselamatan|kasalametan
kekhawatiran|kasalempang
terlihat|kasampak
tampaknya|kasampak
tampak|kasampak
latar|kasang
tersangka|kasangka
kesepakatan|kasapukan
keseragaman|kasaragaman
ketiduran|kasarean
tersesat|kasasar
kesetiaan|kasatiaan
tersebut|kasebut
peluang|kasempetan
kesempatan|kasempetan
kesenian|kasenian
kesiangan|kasiangan
anugrah|kasinugrahan
anugerah|kasinugrahan
teralami|kasorang
kesulitan|kasulitan
kasusnya|kasusna
kesehatan|kasehatan
ganteng|kasep
kagum|kataji
terlantar|katalayah
bingung|katalimbeng
dilanda|katandangan
teraniaya|katandasa
ketentuan|katangtuan
ketatanegaraan|katatanagaraan
kategori|kategori
dijuluki|katelahna
kebiadaban|katelengesan
kelihatan|katempo
kelihatannya|katempona
perdamaian|katengtreman
keterangan|katerangan
ketidakpastian|kateupastian
ketiga|katilu
terkepung|katingker
ketentraman|katingtriman
teramati|katitenan
katolik|katolik
kecintaan|katresna
kanan|katuhu
tertolong|katulung
pelangi|katumbiri
teratasi|katungkulan
tertimbun|katuruban
berikut|katut
tertutup|katutup
tertutupi|katutupan
tertembak|katembak
terlihat|katembong
terukur|kaukur
permainan|kaulinan
mainan|kaulinan
kaum|kaum
terungkap|kaungkab
keuntungan|kauntungan
tertimbun longsor|kaurugan
tergerak|kausikkeun
kewajiban|kawajiban
kewajibannya|kawajibanana
kewalahan|kawalahan
kenalan|kawanohan
seperti|kawas
seakan|kawas
bagaikan|kawas
seolah|kawas lamun
kuasa|kawasa
terbatas|kawates
lagunya|kawihna
kebijakan|kawijakan
terbilang|kawilang
terkenal|kawentar
keyakinan|kayakinan
pink|kayas
kekalahan|kaeleh
keesaan|kaesaan
penuh|kebek
tembem|kebi
kebun|kebon
kata|kecap
ucap|kedal
ucapan|kedalan
katakanlah|kedalkeun
ungkapnya|kedalna
malas|kedul
kemben|kekemben
kekar|keker
kelas|kelas
warna|kelir
pemalu|kemba
kembang|kembang
bunga|kembang
kamis|kemis
kulum|kemot
kempes|kempes
gendang|kendang
kental|kentel
genteng|kenteng
tarik|kenyang
tepuk tangan|keprok
keris|keris
kertas|kertas
sepet|kesed
gesit|kesit
rendam|keueum
tumit|keuneung
lengang|keupat
kepal|keupeul
sedang|keur
ngapain|keur naon
pasir|keusik
cekung|kewung
kiamat|kiamat
kedipan|kiceupan
selatan|kidul
gini|kieu
begini|kieu
kencing|kiih
roda|kikiping
kilometer|kilometer
kios|kios
gerai|kios
kiosnya|kiosna
kira|kira
sekitar|kira-kira
sinyalemen|kira-kira
kiranya|kirana
kirim|kirim
pasokan|kiriman
keruh|kiruh
kitab|kitab
gitu|kitu
demikian|kitu
begitu|kitu
lagi-lagi|kitu deui
begitulah|kitu pisan
kini|kiwari
koalisi|koalisi
kode|kode
kentongan|kohkol
koin|koin
melarat|kokoro
kotoran|kokotor
kolonial|kolonial
kolonel|kolonel
orang tua|kolot
tua|kolot
orangtua|kolot
orang tuanya|kolotna
baling-baling|kolecer
koma|koma
komandan|komandan
komandannya|komandanna
komando|komando
wibawa|komara
wibawanya|komarana
komisaris|komisaris
bahkan|komo
kompetisi|kompetisi
komponen|komponen
komputer|komputer
komputernya|komputerna
kompensasi|kompensasi
komentar|komentar
komentarnya|komentarna
komersial|komersial
kunci|konci
kuncinya|koncina
kemaluan laki-laki|kanjut
kondisinya|kondisina
konferensi|konferensi
kalung|kongkorong
kongres|kongres
konspirasi|konspirasi
konsul|konsul
konsumsi|konsumsi
konsumen|konsumen
konsep|konsep
kontak|kontak
koneksi|koneksi
kunyit|koneng
kuning|koneng
koperasi|koperasi
kopi|kopi
koran|koran
korban|korban
kurma|korma
keropos|koropok
korps|korps
korpsnya|korpsna
kursi|korsi
kursinya|korsina
koreksi|koreksi
koresponden|koresponden
kosong|kosong
kotak|kotak
ayam|kotok
cakar|koet
krisis|krisis
kristen|kristen
kritik|kritik
kritis|kritis
oleh|ku
dengan cara|ku cara
sehingga|ku kituna
untuk itu|ku kituna
dengan demikian|ku kituna
dengan sendirinya|ku sorangan
kualitas|kualitas
kualitasnya|kualitasna
kuat|kuat
kecewana|kuciwana
kuda|kuda
mesti|kudu
harus|kudu
berbayar|kudu mayar
kudeta|kudeta
kue|kueh
kuis|kuis
kujang|kujang
kuku|kuku
mencuci|kukumbah
kupu-kupu|kukupu
keluarga|kulawarga
keluarganya|kulawargana
kuliah|kuliah
kuliahnya|kuliahna
kelimis|kulimis
kulit|kulit
barat|kulon
rebus|kulub
gimana|kumaha
bagaimana|kumaha
bagaimanapun|kumaha oge
cuci|kumbah
kumis|kumis
komplet|kumplit
kuno|kuna
pernah|kungsi
kuningan|kuningan
puntung|kuntung
komat-kamit|kunyam-kunyem
anting|kurabu
kurang|kurang
cemberut|kuraweud
keliling|kuriling
sangkar|kurung
kusut|kusial
rupanya|kutan
kura-kura|kuya
genangan|kuyumbang
bidik|keceng
bidikan|kecengan
kidal|kede
keder|keder
ketiak|kelek
ketek|kelek
kiri|kenca
kiri-kanan|kenca-katuhu
tersenyum|keom
keriput|kerod
keringat|kesang
jatuh|labuh
pedas|lada
pelayan|laden
lagu|lagu
lagunya|laguna
melihat-lihat|laha-loho
lahan|lahan
lahannya|lahanna
lahir|lahir
bukanlah|lain
bukan|lain
bukannya|lainna
bukankah|lainna
lengkuas|laja
kolom|lajur
rumah tangga|laki-rabi
laksamana|laksamana
laku|laku
perilaku|laku-lampah
nonton|lalajo
menonton|lalajo
pria|lalaki
laki-laki|lalaki
lelaki|lalaki
peranan|lalakon
perjalanan|lalampahan
tirai|lalangse
tirainya|lalangsena
perlawanan|lalawanan
gegabah|lalawora
lalat|laleur
gelombang|lambak
lambang|lambang
buah kain|lambar lawon
belepotan|lambokot
tindak|lampah
kelakuan|lampah
lereng|lamping
lampu|lampu
seandainya|lamun
kalo|lamun
kalaupun|lamun
kalau|lamun
jika|lamun
bila|lamun
apabila|lamun
rabun|lamur
laba-laba|lancah
lancar|lancar
kakak|lanceuk
lembah|landeuh
julukan|landian
alias|landian
pelanggan|langganan
langganan|langganan
pelanggannya|langgananna
abadi|langgeng
langit|langit
langka|langka
tinjau|langlang
tinjauan|langlangan
langsung|langsung
lantaran|lantaran
karenanya|lantaran eta
tertib|lantip
lantai|lante
lapangan|lapang
lapar|lapar
laporan|laporan
laporannya|laporanana
larangan|larangan
laras|laras
latihan|latihan
berlatih|latihan
ikan|lauk
lambat|laun
laut|laut
lawan|lawan
kain|lawon
layan|layan
layanan|layanan
layar|layar
mayat|layon
jenazah|layon
jauh|laer
lebaran|lebaran
abu|lebu
luas|lega
telan|legleg
berakhir|lekasan
lembaga|lembaga
lembaran|lembaran
lembong|lembong
kampung|lembur
halus|lemes
lurus|lempeng
lengkapi|lengkepan
lebat|leubeut
mendingan|leuheung
tekun|leukeun
lemas|leuleus
berjalan|leumpang
tangan|leungeun
tangannya|leungeunnya
hilang|leungit
hilangnya|leungitna
terlepas|leupas
lolos|leupas
lusuh|leuseuh
lumpur|leutak
kecil|leutik
hutan|leuweung
hutan lindung|leuweung tutupan
lubuk|leuwi
terlebih|leuwih
lebih|leuwih
sebaiknya|leuwih hade
lebih dalam|leuwih jero
terlebih dulu|leuwih tiheula
terlebih dahulu|leuwih tiheula
lebih dulu|leuwih tiheula
lebih dahulu|leuwih tiheula
lubang|liang
lainnya|lianna
licik|licik
pusing|lieur
lama|lila
lama-kelamaan|lila-lila
lama kelamaan|lila-lila
lamanya|lilana
lima|lima
berlima|limaan
luber|limpas
pelupa|limpeuran
lin dan|lin dan
jinak|lindeuk
lingkungan|lingkungan
lindu|lini
gempa|lini
montok|lintuh
menipu|linyok
lipat|lipet
bagaikan|lir
listrik|listrik
lesung|lisung
lisensi|lisensi
liter|liter
bandel|liwar
lewat|liwat
jamak|loba
banyak|loba
banyaknya|lobana
longgar|logor
situs|loka
lokasi|lokasi
letak|lokasi
kebanyakan|lolobana
buta|lolong
lemari|lomari
lubang|lombang
los|los
lowongan|lowongan
luar|luar
berminyak|lucir
lucu|lucu
tinggi|luhur
atas|luhur
luhurnya|luhurna
ketinggiannya|luhurna
atasnya|luhurna
lumut|lukut
pimpinan|lulugu
berlarian|lulumpatan
lulus|lulus
lulusan|lulusan
berlaku|lumaku
terjadi|lumangsung
berlangsung|lumangsung
lumayan|lumayan
lari|lumpat
berlari|lumpat
loncat|luncat
sesuai|luyu
ingus|leho
iler|leho
cincin|lelepen
lancip|lencop
langkah|lengkah
langkahi|lengkahan
lembah|lengkob
lengkong|lengkong
lidah|letah
jilat|letak
letkol|letkol
letnan|letnan
meleleh|leeh
maklum|ma'lum
pengap|mabek
mabuk|mabok
membaca|maca
baca|maca
berdikari|macakal
membacanya|macana
bercengkrama|macangkrama
macam|macem
mematuk|macok
berdecak|macrek
mencangkul|macul
mencangkulnya|maculna
menyamai|madanan
melacur|madon
madya|madya
memagari|mageran
maghrib|magrib
merajalela|mahabu
mahal|mahal
maskawin|mahar
mahasiswa|mahasiswa
cukup untuk|mahi keur
mahkamah|mahkamah
mahir|maher
majalah|majalah
majelis|majelis
maju|maju
majunya|majuna
memakainya|makena
maksud|maksud
maksudnya|maksudna
mahkota|makuta
mengenakan|make
memakai|make
menggunakannya|makena
memakainya|makena
justru|malahan
malang|malang
malaikat|malaekat
mahligai|malige
berbalik|malik
menyelusuri|maluruh
risiko|mamala
paman|mamang
pemanis|mamanis
mana|mana
manajemen|manajemen
mancanegara|mancanagara
menancapkan|mancegkeun
memancing|mancing
mancung|mancung
mandi|mandi
mempengaruhi|mangaruhan
memengaruhi|mangaruhan
silahkan|mangga
baiklah|mangga
temukan|manggihan
menemukan|manggihan
menemui|manggihan
manggis|manggu
memikul|manggul
maka|mangka
membuatkan|mangnyieunkeun
manfaat|mangpaat
manfaatnya|mangpaatna
merupakan|mangrupa
berupa|mangrupa
masa|mangsa
bertahun-tahun|mangtaun-taun
sampai|mani
hingga|mani
sperma|mani
semen|mani
memanjang|manjang
memperpanjang|manjangkeun
membantu|mantuan
burung|manuk
manusia|manusa
manyun|manyun
kamu|maneh
ia|manehna
dialah|manehna
dia|manehna
mencuri|maok
meninggal dunia|maot
meninggal|maot
wafatnya|maotna
kematiannya|maotna
menjemput|mapag
menghalang-halangi|mapalangan
ceria|marahmay
bersinar-sinar|marahmay
kalian|maraneh
mereka|maranehanana
menemani|marengan
maret|maret
memeriksa|mariksa
maritimnya|maritimna
markas|markas
markasnya|markasna
memarkir|markir
memerintah|marentah
menginstruksikan|marentahkeun
memerintahkan|marentahkeun
memasak|masak
persoalan|masalah
permasalahan|masalah
masalah|masalah
masalahnya|masalahna
memasang|masangkeun
masyarakat|masarakat
memasarkannya|masarkeunnana
masih|masih
mesjid|masjid
masjid|masjid
massa|massa
memastikan|mastikeun
memungkinkan|matak bisa
mencurigakan|matak curiga
menyedihkan|matak hanjelu
mengagumkan|matak helok
menghebohkan|matak ibur
mengharukan|matak kagagas
mengherankan|matak olohok
materiil|materil
menemani|maturan
mematenkan|matenkeun
harimau|maung
membawa|mawa
berbekal|mawa bekel
melarikan|mawa lumpat
maya|maya
membayar|mayar
terus-menerus|mayeng
mayat|mayit
mayor|mayor
membunuh|maehan
judi|maen
sepakbola|maen bal
menancap|mebes
mencoba|mecakan
muncul|mecenghul
terbit|medal
menerbitkan|medar
beredar|medar
beredarnya|medarna
mendung|meded
memutuskan|megatkeun
mekar|mekar
menanam|melak
kuatir|melang
menggembung|melendung
melengkungkan|melengkungkeun
menatap|melong
memandang|melong
lengah|meleng
membendung|mendet
lebih baik|mending
menyekat|menggel
asma|mengi
mengkal|mengkel
menit|menit
menitan|menitan
menteri|menteri
mewah|mentereng
kemenyan|menyan
memerangi|merangan
mempercayai|mercayaan
mempercayakan|mercayakeun
merdeka|merdika
nyaman|merenah
memeras|meres
memerlukan|merlukeun
membutuhkan|merlukeun
memesan|mesen
mesin|mesin
mengupas|mesek
menarik|metot
layak|meujeuhna
memanggang|meuleum
membeli|meuli
mendapat|meunang
menang|meunang
memperoleh|meunang
memenangkan|meunang
diperbolehkan|meunang
mendapatkan|meunangkeun
menyembelih|meuncit
mumpung|meungpeung
menilai|meunteun
memecah|meupeus
mungkin|meureun
memijat|meuseul
memelihara|miara
mempunyai|miboga
berwatak|miboga watek
membuang|miceun
mengerjakannya|migawena
berbuat|migawe
bekerjasama|migawe bareng
memihak|mihak
mengharap|miharep
menyukai|mikaresep
mengidentifikasi|mikawanoh
mengenali|mikawanoh
mengenal|mikawanoh
menyerahkan|mikeun
memberikan|mikeun
memberi|mikeun
mengira|mikir
berpikir|mikir
memikirkan|mikiran
memikirkannya|mikiranana
berperilaku|milampah
memilih|milih
memilih-milih|milih-milih
milik|milik
milikna|milikna
militer|militer
ikut|milu
ambil bagian|miluan
mengikuti|miluan
ikutan|miluan
milyar|milyar
miliar|milyar
milyaran|milyaran
milyarnya|milyarna
pertama kali|mimiti
mulai|mimiti
awal|mimiti
mulailah|mimitian
semula|mimitina
awalnya|mimitina
sebagai|minangka
menantu|minantu
memindah-mindahkan|mindah-mindahkeun
memindahkan|mindahkeun
mengevakuasi|mindahkeun (evakuasi)
sering|mindeng
kerap|mindeng
pekan|minggu
minggu|minggu
mingguan|mingguan
memimpin|mingpin
mini|mini
minoritas|minoritas
menampilkan|mintonkeun
tumpul|mintul
memenuhi|minuhan
memadati|minuhan
minyak|minyak
memisahkan|misahkeun
sepupu|misan
miskin|miskin
memulai|mitembeyan
mertua|mitoha
mertuanya|mitohana
mitra|mitra
mencintai|mitresna
memperingati|mieling
tak akan|moal
takkan|moal
tidak akan|moal
mobil|mobil
modal|modal
mode|mode
model|model
modem|modem
moderen|moderen
melotot|molotot
momentum|momentum
menerobos|moncor
sorot|moncorong
menyorot|moncorong
memendekkan|mondokkeun
monyet|monyet
melupakan|mopohokeun
memburu|moro
berburu|moro
kemerosotan|morosotna
memotong|motong
motor|motor
memproduksi|mroduksi
muatan|muatan
menurun|mudun
semoga|muga
memuja|muja
menyanjung|muji
memuji|muji
membuka|muka
bergumul|muket
mengembalikan|mulangkeun
memelintir|mulintirkeun
muluskan|muluskeun
sarapan|mumuluk
munafik|munapek
memercik|muncrat
padat|mundel
kerbau|munding
mundur|mundur
mengundurkan|mundurkeun
mundurnya|mundurna
mengakhiri|mungkas
luntur|muntah
jatuh|murag
murah|murah
mengkerut|murengked
meringis|muringis
menyala|murub
rontok|murudul
bencana|musibah
museum|musieum
muslim|muslim
muslimat|muslimat
muslimin|muslimin
tidak mungkin|mustahil
tak mungkin|mustahil
nggak mungkin|mustahil
mustahil|mustahil
memutar|muter
berputar|muter
menghabiskan|meakkeun
media|media
medis|medis
mei|mei
meja|meja
mekanik|mekanik
mekaniknya|mekanikna
belok|mengkol
mohon|menta
minta|menta
meminta|menta
merk|merek
merkuri|merkuri
ngasih|mere
mengabari|mere beja
bermanfaat|mere mangpaat
tersenyum|mesem
meter|meter
meteran|meteran
nya|na
menabuh|nabeuh
nabi|nabi
negara|nagara
negaranya|nagarana
negeri|nagari
mandek|nagen
menagih|nagih
kenapa|naha
apakah|naha
mengapa|naha
menahan|nahan
berduyun-duyun|nakleuk
memukul|nakol
menderita|nalangsara
menendang|nalapung
berpesan|nalatahan
menyelidiki|nalungtik
meneliti|nalungtik
menambahkan|nambahan
menambah|nambahan
bertambah|nambahan
menerima|nampa
menolak|nampik
mempertanyakan|nananyakeun
apa-apa|nanaon
menandakan|nandakeun
melanda|nandangan
menindas|nandasa
menandatangani|nandatanganan
mempertaruhkan|nandonkeun
menampung|nandean
menampungnya|nandeanana
menanggapi|nanggepan
menanggung|nanggung
terlentang|nangkarak
menantang|nangtang
curam|nangtawing
proteksi|nangtayungan
melindungi|nangtayungan
menentukan|nangtukeun
berdiri|nangtung
menandaskan|nanjeurkeun
beruntung|nanjung
bertanya|nanya
bertanya-tanya|nanya-nanya
menanyakan|nanyakeun
apa|naon
apapun|naon oge
apakan|naonkeun
nafkah|napakah
nafsu|napsu
menyerang|narajang
neraka|naraka
menargetkan|nargetkeun
menerima|narima
mengusahakan|narekahan
mengupayakan|narekahan
berupaya|narekahan
nasib|nasib
nasional|nasional
nasrani|nasrani
bertamu|natamu
navigasi|navigasi
menawarkan|nawarkeun
naik|naek
menaiki|naekan
menaikkan|naekkeun
menegaskan|negeskeun
menelan|nelen
bertelepon|nelepon
menembus|nembus
penempatan|nempatkeun
menempatkan|nempatkeun
melihat|nempo
memperlihatkan|nempokeun
memperhatikan|nengetan
memerhatikan|nengetan
telak|nenggel
sampai|nepi ka
hingga|nepi ka
menyampaikan|nepikeun
menjumpai|nepungan
menemui|nepungan
menerapkan|nerapkeun
berlanjut|nerus
ngelanjutin|neruskeun
menindaklanjuti|neruskeun
meneruskan|neruskeun
melanjutkan|neruskeun
menetapkan|netepkeun
mendalami|neuleuman
memukul|neunggeul
memukuli|neunggeulan
nge|nga
men|nga
mengindonesia|nga-Indonesia
membaik|ngaalusan
melahirkan|ngababarkeun
persahabatan|ngababaturan
membacakan|ngabacakeun
membagi|ngabagi
menyambut|ngabageakeun
membahas|ngabahas
membahayakan|ngabahayakeun
ngulum|ngabaheum
membangkang|ngabahula
membajak|ngabajo
melempar|ngabalangkeun
membelanjai|ngabalanjaan
membalas|ngabales
menyebabkan|ngabalukarkeun
menimbulkan|ngabalukarkeun
mengakibatkan|ngabalukarkeun
membantu|ngabantuan
membatasi|ngabatesan
berteman|ngabatur
membawanya|ngabawa
membayangkan|ngabayangkeun
memberitahu|ngabejaan
mengentuti|ngabekokan
menggelegar|ngabeledag
memperbaiki|ngabenerkeun
membenarkan|ngabenerkeun
memperbaikinya|ngabenerkeunana
membersihkan|ngabersihkeun
membakar|ngabeuleum
memberatkan|ngabeungbeuratan
membebani|ngabeungbeuratan
memerahkan|ngabeureumkeun
membiayai|ngabiayaan
memihak|ngabiluk
membina|ngabina
membingungkan|ngabingungkeun
menyampuk|ngabintih
bergidik|ngabirigidig
membocorkan|ngabocorkeun
memiliki|ngabogaan
berhak|ngabogaan hak
bertugas|ngabogaan tugas
mengurungkan|ngabolaykeun
membatalkan|ngabolaykeun
melubangi|ngabolongan
memborbardir|ngabombardir
berbondong-bondong|ngabrul
membubarkan|ngabubarkeun
membedakan|ngabedakeun
mempertahankan|ngabela
menyelesaikan|ngabereskeun
ngaco|ngaco
dadakan|ngadadak
memaparkan|ngadadarkeun
bergumpal|ngadagleg
menanti|ngadagoan
memakan|ngadahar
tengkurap|ngadakom
mengontrol|ngadalikeun
mengendalikan|ngadalikeun
telungkup|ngadapang
mendaftar|ngadaptar
mendasar|ngadasar
mengunjungi|ngadatangan
mendatangkan|ngadatangkeun
menegakkan|ngadegkeun
mendirikan|ngadegkeun
mendekam|ngadekem
mendelik|ngadelek
mendesak|ngadesek
mendekati|ngadeukeutan
menggumpal|ngadigleg
mendistribusikan|ngadistribusikeun
menghadiahkan|ngado
menghadiahi|ngadoan
menyengaja|ngadon
meninjau|ngadongdon
menjangkau|ngadongkang
menggali|ngadongkar
mendongengkan|ngadongengkeun
merenggut|ngadudut
mengadukan|ngadukeun
membakar|ngaduruk
berdiang|ngadeang
menggigil|ngadegdeg
berdehem|ngadehem
membacok|ngadek
mendeklarasikan|ngadeklarasikeun
mendengar|ngadenge
berayun-ayun|ngagabig
merangkul|ngagabrug
bergabung|ngagabung
menggabungkan|ngagabungkeun
remas|ngagacel
menanduk|ngagadil
oleng|ngagaleong
menggambarkan|ngagambarkeun
memudahkan|ngagampangkeun
membebani|ngaganggayong
mengganggu|ngaganggu
mengganjal|ngaganjel
mengganti|ngaganti
menggantikan|ngagantikeun
menggantinya|ngagantina
bergantung|ngagantung
menggantungkan|ngagantungkeun
mengeringkan|ngagaringkeun
mengunyah|ngagayem
menghalau|ngagebah
terperosok|ngagebros
terbentur|ngageduk
memperbesar|ngagedean
menganut|ngagem
beragama|ngagem agama
memupuk|ngagemukan
mengaum|ngagerem
berguman|ngagereyem
memanggil|ngagero
membangunkan|ngageuingkeun
mengeluh|ngageuri
menggiling|ngagiling
menyalak|ngagogog
mengonggong|ngagogogan
mendidih|ngagolak
berbaring|ngagoler
menggoreng|ngagoreng
menggotong|ngagotong
bergulir|ngagulundung
menggunakan|ngagunakeun
mengigau|ngagundam
mengagungkan|ngagungkeun
menggosok-gosok|ngagusrukan
menggusur|ngagusur
meliuk-liuk|ngageboy
menyisihkan|ngagehan
mengeser-geser|ngageser-geser
menghadiri|ngahadiran
hadiri|ngahadiran
sengaja|ngahaja
berharap|ngaharepkeun
menghargai|ngahargaan
mengapresiasi|ngahargaan
berbisik|ngaharewos
menghasilkan|ngahasilkeun
menghaturkan|ngahaturkeun
mengejan|ngaheujeun
memperketat|ngaheureutkeun
berkibar|ngahibar
berdesing|ngahieng
bersatu|ngahiji
menghidupkan|ngahirupkeun
meraih|ngahontal
menggapai|ngahontal
mencapai|ngahontal
menghormati|ngahormatan
menyuapi|ngahuapan
membangunkan|ngahudangkeun
melarang|ngahulag
termenung|ngahuleng
menyulitkan|ngahesekeun
menipisnya|ngaipisanana
menggendong|ngais
menyangkut|ngait
merampas|ngajabel
menjadikan|ngajadikeun
menjadikannya|ngajadikeunna
menjaga|ngajaga
berjaga|ngajaga
berjaga-jaga|ngajaga-jaga
menjajah|ngajajah
berbaris|ngajajar
mengajak|ngajak
menjalani|ngajalanan
menjalankan|ngajalankeun
menjalankannya|ngajalankeunana
menjamin|ngajamin
menjelma|ngajanggelek
menjanjikan|ngajangjian
mengajarkan|ngajarkeun
menisik|ngajarumat
mencuat|ngajaul
mencibir|ngajebian
merobek-robek|ngajejewet
menerangkan|ngajelaskeun
meledak|ngajelegur
tersentak|ngajenghok
terperangah|ngajenghok
menjerit|ngajerit
menjinjing|ngajingjing
loncat|ngajleng
meneriakkan|ngajorowokeun
menjual|ngajual
menjolok|ngajul
mengelompok|ngajumpluk
menjunjung|ngajungjung
menyuruh|ngajurung
menghargai|ngajenan
membongkar|ngakat
mendekap|ngakeup
mengakui|ngaku
mengaku|ngaku
mengatasnamakan|ngaku-ngaku
melepaskan|ngalaan
menjatuhkan|ngalabuhkeun
melayani|ngaladenan
meladeni|ngaladenan
memangku|ngalahun
melakukan|ngalakonan
melakukannya|ngalakonanana
melaksanakan|ngalaksanakeun
menunaikan|ngalakukeun
melakukan|ngalakukeun
berkelana|ngalalana
mengalami|ngalaman
ngelamun|ngalamun
melamun|ngalamun
melanggengkan|ngalanggengkeun
meninjau|ngalanglang
melapor|ngalapor
melaporkan|ngalaporkeun
menerapkannya|ngalarapkeunana
melatih|ngalatih
melawan|ngalawan
menengok|ngalayad
melayang|ngalayang
melayangkan|ngalayangkeun
meluas|ngalegaan
menekuni|ngaleukeunan
menghilangkan|ngaleungitkeun
melebihi|ngaleuwihan
melampaui|ngaleuwihan
menginjak-nginjak|ngaleyek
menggali|ngali
nyetrika|ngalicin
menoleh|ngalieuk
mengigau|ngalindur
mengelilingi|ngalingkung
berlipat|ngalipet
melintas|ngaliwat
melewati|ngaliwatan
melalui|ngaliwatan
melewatkan|ngaliwatkeun
mengerahkan|ngaluarkeun
mengeluarkan|ngaluarkeun
melansir|ngaluarkeun
melucuti|ngalucutan
menghadiri|ngaluuhan
memperolok-olok|ngalelewe
menggandeng|ngaleng
melangkah|ngalengkah
melangkahi|ngalengkahan
melata|ngaleor
memajukan|ngamajukeun
memaklumi|ngamaklum
memaknai|ngamaknaan
memanfaatkan|ngamangpaatkeun
mengamankan|ngamankeun
memasyarakatkan|ngamasarakatkeun
mengarungi|ngambah
berjuntai|ngambay
memekarkan|ngamekarkeun
memenangi|ngameunangan
meremehkan|ngamomorekeun
menghampar|ngampar
bermuara|ngamuara
mengamuk|ngamuk
memuliakan|ngamuliakeun
hanya|ngan
cuman|ngan
cuma|ngan
mengancam|ngancem
menghancurkan|ngancurkeun
berhenti|ngandeg
mempertebal|ngandelan
mengandalkan|ngandelkeun
mengandung|ngandung
menganga|ngangah
menganggap|nganggap
menganggapnya|nganggap hal eta
menganggarkan|nganggarkeun
menyikapi|nganggepan
nganggur|nganggur
mengangkang|ngangkang
berjongkok|ngangkog
mangkir|ngangles
menggembala|ngangon
menghasut|ngangson
menganiaya|nganiaya
menistakan|nganistakeun
berkunjung|nganjang
berutang|nganjuk
antri|ngantay
membiarkan|ngantep
mengantar|nganteur
mengantarkan|nganteurkeun
mengantongi|ngantongan
berterimakasih|nganuhunkeun
berterimakasih sekali|nganuhunkeun pisan
menghapalkan|ngapalkeun
menghafal|ngapalkeun
terbang|ngapung
menjahit|ngaput
meracik|ngaracik
mengarak|ngarak
mendekatkan|ngaraketkeun
meralat|ngaralat
nama|ngaran
mengarang|ngarang
namanya|ngaranna
bernama|ngaranna
merapikan|ngarapikeun
merancang|ngararancang
melarangnya|ngararangna
merasa-rasakan|ngararasakeun
merasa|ngarasa
merasakan|ngarasakeun
menikmati|ngarasakeun
merayakan|ngarayakeun
merayap|ngarayap
merebut|ngarebut
mendengarkan|ngaregepkeun
mengharapkan|ngarep-ngarep
meramaikan|ngareuah-reuah
mengistirahatkan|ngareureuhkeun
meringkuk|ngaringkuk
berkumpul|ngariung
berkumpulnya|ngariungna
merubah|ngarobah
mengubah|ngarobah
merodok|ngarojok
menunjang|ngarojong
mendukung|ngarojong
menunjangnya|ngarojongna
meningkatkan|ngaronjatkeun
menggapai-gapai|ngaroes
mengubur|ngaruang
mengerumuni|ngarubung
merugikan|ngarugikeun
merujuk|ngarujuk
mengacu|ngarujuk
merumuskan|ngarumuskeun
merusak|ngarusak
merekam|ngarekam
melanggar|ngarempak
menuntaskan|ngarengsekeun
melirik|ngareret
merevisi|ngarevisi
mengganggu|ngarewong
mencicipi|ngasaan
mengasah|ngasah
menyodorkan|ngasongkeun
mengasumsikan|ngasumsikeun
memasuki|ngasupan
memasukkan|ngasupkeun
mendidik|ngatik
mewadahi|ngawadahan
mewakili|ngawakilan
membangun|ngawangun
berbentuk|ngawangun
pengenalan|ngawanohan
memperkenalkan|ngawanohkeun
menawar|ngawar
mewariskan|ngawariskeun
mewarnai|ngawarnaan
memberitakan|ngawartakeun
menguasai|ngawasa
berkuasa|ngawasa
memantau|ngawaskeun
membatas|ngawates
poligami|ngawayuh
berpoligami|ngawayuh
mendayung|ngawelah
mencakup|ngawengku
meliputi|ngawengku
memilah-milah|ngawilah-wilah
merinci|ngawincik
menghasut|ngawisuna
memanjakan|ngawowoy
mewujudkan|ngawujudkeun
mewujudkannya|ngawujudkeunana
menabur|ngawur
mengajari|ngawurukan
menyaring|ngayak
pengadaan|ngayakeun
mengadakan|ngayakeun
meyakini|ngayakinan
meraba-raba|ngayap
mengayun|ngayun
berbaring|ngebog
mengepul|ngebul
mengutarakan|ngedalkeun
mengucapkan|ngedalkeun
mengucap|ngedalkeun
rebahan|ngedeng
rebah|ngedeng
berbaring|ngedeng
mengeduk|ngeduk
mengelas|ngelas
ngiler|ngelay
tersipu-sipu|ngeleketek
ciut|ngeleper
berkembang|ngembang
mengembangkan|ngembangkeun
ngepit|ngempit
berkilauan|ngempur
menghisap|ngenyot
terkulai|ngeplek
mengepel|ngepel
menerkam|ngerekeb
mengurung|ngerem
merendam|ngeueum
tentang|ngeunaan
mengenai|ngeunaan
enak|ngeunah
bercermin|ngeunteung
mengepalkan|ngeupeulkeun
menghentikan|ngeureunkeun
mengisi|ngeusian
meniadakan|ngeuweuhkeun
berkedip|ngiceup
memperbolehkannya|ngidinan manehna
raib|ngiles
menghilang|ngiles
mengimani|ngimanan
mengamati|ngimeutan
membeku|ngimpel
mimpi|ngimpi
mengingat|nginget
peringati|ngingetan
mengingatkan|ngingetkeun
mengintip|ngintip
meminum|nginum
menipis|ngipisan
mengebutkan|ngirabkeun
mengirim|ngirim
mengirimkan|ngirimkeun
berdering|ngirining
berak|ngising
melantik|ngistrenan
menghitung|ngitung
mengobarkan|ngobarkeun
bercakap-cakap|ngobrol
mengocok|ngoclok
mengalir|ngocor
mengalirkan|ngocorkeun
mengaduk|ngocek
batuk-batuk|ngohkoh
berenang|ngojay
mengolah|ngokolakeun
mengelola|ngokolakeun
berolahraga|ngolah raga
mengulum|ngolomoh
menua|ngolotan
ngomong|ngomong
mengatakan|ngomong
bilang|ngomong
bicara|ngomong
berkata|ngomong
berbicara|ngomong
membicarakan|ngomongkeun
bicaranya|ngomongna
berkomentar|ngomentaran
mengundang|ngondang
mengontrak|ngontrak
mengontraknya|ngontrak manehna
muda|ngora
mengorbankan|ngorbankeun
berkorban|ngorbankeun
merangkak|ngorondang
bangkit|ngorejat
mengoreksi|ngoreksi
menggosok|ngosok
mencari-cari|ngotektak
mengguncang|ngoyagkeun
menguatkan|nguatkeun
memperkuat|nguatkeun
ngobrak-ngabrik|ngubrak-abrik
mengecewakan|nguciwakeun
mengejar|ngudag
merokok|ngudud
melunakkan|nguduhkeun
mengharuskan|ngudukeun
memanjakan|ngugung
menggeliat|nguliat
mengultimatum|ngultimatum
murung|nguluwut
keluyuran|nguluyur
mengembara|ngumbara
mengumpulkan|ngumpulkeun
menuturkan|ngunggelkeun
mengungkap|ngungkab
mengungkapkan|ngungkabkeun
mengangkut|ngunjalan
menguntungkan|nguntungkeun
mengurangi|ngurangan
berkurang|ngurangan
menguras|nguras
menjerat|ngured
merajuk|ngurihit
mengurus|ngurus
mengurusi|nguruskeun
memancing|nguseup
menggerakkan|ngusikkeun
mengusir|ngusir
menyarankan|ngusulkeun
mengajukan|ngusulkeun
mengutamakan|ngutamakeun
bersungut-sungut|ngutruk
mengutus|ngutus
paceklik|nguyang
menggenang|nguyumbang
menjahit|ngecos
menghina|ngece
melecehkan|ngece
membidik|ngeceng
mengecer|ngecer
menjelaskan|ngeceskeun
menggigit|ngegel
mengalah|ngelehan
mengalahkan|ngelehkeun
mencanangkan|ngembarkeun
memalukan|ngerakeun
mengingsud|ngesod
niat|niat
menikah|nikah
menikahi|nikah ka
menikahinya|nikah ka manehna
nikmatnya|nikmatna
pertimbangkan|nimbang-nimbang
mempertimbangkan|nimbang-nimbang
debug|nindes
menindih|nindihan
meninggalkan|ninggalkeun
mengepung|ningker
nenek|nini
meniru-niru|niron-niron
mengamati|nitetan
menewaskan|niwaskeun
memenuhi|nohonan
menusuk|nojos
nomor|nomer
pemuda|nonoman
november|nopember
nopember|nopember
pemilik|nu boga
pemiliknya|nu bogana
berlainan|nu beda
pengunjung|nu datang
pengunjungnya|nu datangna
gratisan|nu haratis
pembawa|nu mawa
penata|nu nata
pengutang|nu ngahutang
penjaga|nu ngajaga
pelindung|nu ngajaga
pendukung|nu ngarojong
penyelenggara|nu ngayakeun
pengelola|nu ngokolakeun
penulis|nu nulis
penduduk|nu nyicingan
pembuat|nu nyieun
penangkap|nu newak
tertentu|nu tangtu
menuduh|nuduh
menuju|nuju
menukar|nukeur
mengunci|nulak
menulis|nulis
menuliskan|nuliskeun
menuliskannya|nuliskeunana
menolong|nulungan
melanjutkan|nuluykeun
menerpa|numiba
mengendarai|numpakan
menumpang|numpang
menumpas|numpes
memberantas|numpes
menumpuk|numpuk
menumbuhkan|numuwuhkeun
menyimpan|nunda
menunggu|nungguan
mengatasi|nungkulan
menundukkan|nungkulkeun
menuntut|nungtut
menunjuk|nunjuk
menunggu-nunggu|nunungguan
menurunkan|nurunkeun
menurut|nurutkeun
nusantara|nusantara
menutupi|nutupan
menutup|nutupan
menutupkan|nutupkeun
mengikuti|nuturkeun
sayang|nyaah
sungguhan|nyaan
mengakibatkan|nyababkeun
menyebabkan|nyababkeun
menyentuh|nyabak
menyabet|nyabet
bersebelahan|nyabeulahan
menempeleng|nyabok
mencabut|nyabut
menyadap|nyadap
menyadari|nyadar
menyediakan|nyadiakeun
menyehatkan|nyageurkeun
memulihkan|nyageurkeun
tahu|nyaho
mengetahui|nyaho
ketahui|nyaho
menetes|nyakclakan
menyaksikan|nyaksian
mengumumkan|nyalabarkeun
menyalahi|nyalahan
menyelamatkan|nyalametkeun
menyalurkan|nyalurkeun
menyusup|nyalusup
menyelaraskan|nyaluyukeun
memanggil-manggil|nyambat
menyambar|nyamber
terhubung|nyambung
berhubungan|nyambung
menghubungkan|nyambungkeun
menghubungkannya|nyambungkeunana
menyempurnakan|nyampurnakeun
menyempurnakannya|nyampurnakeunana
menyamar|nyamur
menyumbat|nyandet
kecanduan|nyandu
selingkuh|nyandung
menghadap|nyanghareup
menjelang|nyanghareupan
menghadapi|nyanghareupan
menghadapinya|nyanghareupanana
menyangka|nyangka
menduga|nyangka
mencaplok|nyapluk
menyapu|nyapu
mengunyah|nyapek
melarang|nyaram
menjarangkan|nyarangkeun
berbicara|nyarita
menceritakan|nyaritakeun
berkisah|nyaritakeun
bercerita|nyaritakeun
menyamakan|nyaruakeun
menyerupai|nyarupaan
memarahi|nyarekan
nyata|nyata
jelas-jelas|nyata
menyatakan|nyatakeun
menyetujui|nyatujuan
menyepakati|nyatujuan
nyawa|nyawa
mencela|nyawad
nyawanya|nyawana
yakni|nyaeta
yaitu|nyaeta
adalah|nyaeta
menyebarkan|nyebarkeun
menyebutkan|nyebutkeun
menyebut|nyebutkeun
menancap|nyeceb
mendesak|nyedek
mengantisipasi|nyegah
mencegah|nyegah
memegang|nyekel
menjabat|nyekel kalungguhan
bersenjata|nyekel pakarang
berpegang|nyekelan
menyakitkan|nyelekit
mencela|nyempad
menyenangkan|nyenangkeun
menyeringai|nyengir
menyerah|nyerah
menyerbu|nyerbu
menangkap|nyerek
menyerap|nyerepan
menyengat|nyeureud
menyiapkan|nyiapkeun
mempersiapkan|nyiapkeun
menuangkan|nyicikeun
mencicil|nyicil
mencicipi|nyicip
membuat|nyieun
membentuk|nyieun
bikin|nyieun
menyinggung|nyigeung
membasuh|nyimbeuh
mampir|nyimpang
bertandang|nyimpang
meletakkan|nyimpen
mengelak|nyingcet
menghindarkan|nyingcetkeun
menyingkirkan|nyingkahkeun
menyentil|nyintreuk
menciptakan|nyiptakeun
menyepuh|nyipuh
tawon|nyiruan
menyisi|nyisi
mencium|nyium
mencoba-coba|nyoba-nyoba
nyobain|nyobaan
menjorok|nyodor
ngambil|nyokot
mengambil|nyokot
mencontohkan|nyontoan
mencopot|nyopot
mendorong|nyorong
merobek|nyoekkeun
memadai|nyukupan
menculik|nyulik
menyumbang|nyumbang
memenuhi|nyumponan
memenuhinya|nyumponanana
bersembunyi|nyumput
menyembunyikan|nyumputkeun
menyurati|nyuratan
memahami|nyurtian
mendorong|nyurungkeun
menyusul|nyusul
menyusun|nyusun
menyalin|nyutat
mengutip|nyutat
mengalir|nyerelek
menyisakan|nyesakeun
menyewa|nyewa
mencari|neangan
negatif|negatif
menembak|nembak
menembakkan|nembakkeun
menjawab|nembalan
menunjukkan|nembongkeun
melekat|nempel
membantah|nengtereweleng
penularan|nepana
menangkap|newak
menangkapi|newakan
obrolannya|obrolanna
manja|ogo
pun|oge
juga|oge
pula|oge
oktober|oktober
olah|olah
olahraga|olahraga
ole|ole
ucapan|omongan
perkataan|omongan
undangan|ondangan
undangannya|ondanganna
empat|opat
berempat|opatan
operasi|operasi
opini|opini
oposisi|oposisi
optik|optik
oranye|oranyeu
jingga|oranyeu
organisasi|organisasi
bayi|orok
otobiografinya|otobiografina
otomatis|otomatis
otoritas|otoritas
guncang|oyag
berjumpa|paamprok
bertemunya|paamprokna
pembajakan|pabajoan
awut-awutan|pabaliut
pembiayaan|pabiayaan
pabrik|pabrik
perberasan|pabeasan
cangkul|pacul
pacet|pacet
bait|pada
sama-sama|pada-pada
penjual|padagang
pedagang|padagang
padahal|padahal
bermunculan|padamucunghul
berhimpitan|padempet
berdekatan|padeukeut
metode|padika
metoda|padika
pedoman|padoman
berduaan|paduduaan
peduli|paduli
perumahan|padumukan
permukiman|padumukan
berbantahan|padungdengan
pekerja|pagawe
pegawai|pagawe
karyawan|pagawe
pekerjaan|pagawean
kerjaan|pagawean
pagar|pager
erat|pageuh
berebutan|pagorenyang
perguruan|paguron
lusa|pageto
paham|paham
berhadapan|pahareup-hareup
piatu|pahatu
berlomba-lomba|paheula-heula
pahlawan|pahlawan
paceklik|paila
pepes|pais
pahit|pait
pejabat|pajabat
pajak|pajeg
pejuang|pajoang
kusut|pajurawet
perkakas|pakakas
perangkat|pakakas
alat|pakakas
senjata|pakarang
senjatanya|pakarangna
pekerjaan|pakasaban
pake|pake
pakai|pake
gunakan|pake
pakaian|pakean
pelabuhan|palabuhan
pelajaran|palajaran
pelaksanaan|palaksanaan
pelaku|palaku
pelanggaran|palanggaran
selangkangan|palangkakan
pelepah|palapah
pelatih|palatih
pelatihan|palatihan
sebelah|palebah
hanyut|palid
penyelam|palika
pelipis|palipisan
palsu|palsu
palu|palu
pembaca|pamaca
pendapat|pamadegan
pemahaman|pamahaman
istri|pamajikan
isteri|pamajikan
maksudnya|pamaksudanna
pengguna|pamake
pemakai|pamake
penggunaan|pamakean
pemakaian|pamakean
kegunaan|pamakean
tabu|pamali
pemanah|pamanah
pemeriksaan|pamariksaan
pemerintah|pamarentah
pemerintahan|pamarentahan
pemasaran|pamasaran
paruh|pamatuk
nelayan|pamayang
pemain|pamaen
pemotongan hewan|pameuncitan sato
penilaian|pameunteunan
pemikiran|pamikiran
pengikut|pamilu
pengikutnya|pamiluna
pemimpin|pamingpin
pemimpinnya|pamingpinna
pemodal|pamodal
pemrogram|pamrogram
pemrograman|pamrograman
pemujanya|pamujana
pemelihara|pamulasara
terakhir|pamungkas
akhirnya|pamustunganana
permintaan|pamenta
kan|pan
pemukulnya|panakolna
penelitian|panalungtikan
penampungan|panandean
perlindungan|panangtayungan
penerima|panarima
penawaran|panawaran
pancaindra|pancadria
kail|pancing
tugas|pancen
belakangan|pandeuri
sudut pandang|panempo
pemukul|paneunggeul
tatapan|paneuteup
paling|pang
kemampuan|pangabisa
penegak|pangadeg
pendiri|pangadeg
pengadilan|pangadilan
pemeluk|pangagem
pengajaran|pangajaran
penghargaan|pangajen
pengakuan|pangakuan
pengalaman|pangalaman
pengangguran|pangangguran
penganggur|pangangguran
pengantar|panganteur
penganut|panganut
terbaru|panganyarna
penerbangan|pangapungan
pengaruh|pangaruh
penghasilan|pangasilan
pengaturan|pangaturan
pengawas|pangawas
penguasa|pangawasa
penguasaan|pangawasaan
pengetahuan|pangaweruh
pengetahuannya|pangaweruhna
terbesar|pangbadagna
sambutan|pangbagea
sambutannya|pangbageana
pengembalian|pangbalikan
terdekat|pangdeukeutna
pemalas|pangedulan
panggilan|panggero
penggilingan|panggilingan
terburuk|panggorengna
penghinaan|panghina
pemantauan|pangimeutan
penjagaan|pangjagaan
penjajah|pangjajah
penjajahan|pangjajahan
penjajahannya|pangjajahanana
pangkalan|pangkalan
pangkatnya|pangkatna
pelayanan|pangladen
panglima|panglima
tertinggi|pangluhurna
termahal|pangmahalna
terpenting|pangpentingna
penyokong|pangrojong
dukungan|pangrojong
pensiun|pangsiun
pengurus|pangurus
pengusaha|pangusaha
pembangunan|pangwangunan
pembatas|pangwates
tuhan|pangeran
panjang|panjang
penjara|panjara
mata|panon
penonton|panongton
matanya|panonna
matahari|panonpoe
tegang|panteng
pintu|panto
penyelamat|panulung
penunggu|panunggu
penghujung|panungtung
penutup|panutup
penyakit|panyakit
penyempurna|panyampurna
kediaman|panyicingan
kediamannya|panyicinganana
pencipta|panyipta
penciptaan|panyiptaan
penyumbatan|panyocokan
pencopotan|panyopotan
persembunyian|panyumputan
penyehatan|panyehatan
pencarian|paneangan
penembak|panembak
panen|panen
duanya|papadana
papan|papan
pipis|papang
ketemu|papanggih
bertemu|papanggih
pasangannya|papasanganana
capung|papatong
para|para
peralatan|parabot
perabot|parabot
paradoks|paradoks
sampan|parahu
perahu|parahu
kawan-kawan|parakanca
perempatan|parapatan
bertengkar|parasea
tembus|parat
kebetulan|pareng
padam|pareum
paria|paria
peribahasa|paribasa
periksa|pariksa
iklan|pariwara
pariwisata|pariwisata
parkir|parkir
parah|parna
perubahan|parobahan
partai|partei
partainya|parteina
parut|parud
perunggu|parunggu
padi|pare
perintah|parentah
tepat|pas
pas|pas
bertepatan|pas pisan
persegi|pasagi
pasalnya|pasalna
pertemuan|pasamoan
lomba|pasanggiri
pesantren|pasantren
pasar|pasar
persyaratan|pasaratan
pasca|pasca
pasak|paseuk
janji|pasini
bukit|pasir
paspor|paspor
pasrah|pasrah
pasti|pasti
persoalan|pasualan
persoalannya|pasualanana
pasukan|pasukan
terkait|patali
lalu-lintas|patalimarga
lalu lintas|patalimarga
kaitannya|patalina
pertanahan|pataneuhan
petani|patani
petaninya|patanina
pertanyaan|patarosan
kematian|pati
solder|patri
patroli|patroli
petugas|patugas
bertolak-belakang|patukang-tonggong
berkaitan|patula-patali
patung|patung
patut|patut
bersahutan|patembalan
paten|paten
perusahaan|pausahaan
dapur|pawon
payung|payung
februari|pebruari
cambuk|pecut
merica|pedes
lada|pedes
putus|pegat
remuk|pejret
tanam|pelak
gurih|pelem
lengkung|pelengkung
puncak|penclut
pijat|pencet
rendah|pendek
kukuh|pengkuh
penting|penting
pentingnya|pentingna
kabut|pepedut
lengkap|pepek
lengkapnya|pepekna
tanaman|pepelakan
pertempuran|perang
perang|perang
percaya|percaya
terletak|perenahna
perkara|perkara
usah|perlu
perlu|perlu
butuh|perlu
perlu untuk|perlu
perlukan|perlukeun
perlunya|perluna
butuhnya|perluna
persen|persen
pesanan|pesenan
kancil|peucang
usus|peujit
sembelih|peuncit
seberang|peuntas
nilai|peunteun
pecah|peupeus
serak|peura
kepalan|peureup
bogem|peureup
pedih|peurih
perihnya|peurihna
petai|peuteuy
malam|peuting
tape|peuyeum
rahim|pianakan
miliki|piboga
buang|piceun
berbahaya|picilakaeun
sabda|pidawuh
lakukan|pigawe
pihaknya|pihakna
titip|pihape
pipit|piit
mengkhawatirkan|pikahariwangeun
disayangkan|pikalebareun
rindukan|pikasono
untuk|pikeun
bagi|pikeun
kepadanya|pikeun manehna
pikir|pikir
pikiran|pikiran
pikirannya|pikiranana
pikirkan|pikirkeun
perkampungan|pilemburan
pedesaan|pilemburan
kehutanan|pileuweungan
pilih|pilih
pilihan|pilihan
pilihnya|pilihna
payudara|pinareup
pindah|pindah
berpindah|pindah
bermigrasi|pindah
beralih|pindah
gelang|pinggel
paha|pingping
pertunjukan|pintonan
penuh|pinuh
pemenang|pinunjul
bercerai|pirak
banget|pisan
tertawaan|piseurieun
pita|pita
patah|pites
asli|pituin
planet|planet
keasyikan|pogot
sangat|pohara
lupa|poho
pokok|poko
pokoknya|pokona
pola|pola
polimer|polimer
politeisme|politeisme
pendek|pondok
pengawal|ponggawa
popor|popor
populasi|populasi
portalnya|portalna
posisi|posisi
posisinya|posisina
foto|poto
fotonya|potona
potong|potong
hari|poe
hari ini|poe ieu
kemudian hari|poe kahareupnakeun
hari bersejarah|poe nu miboga ajen sajarah
hari itu|poe eta
harian|poean
harinya|poena
praktik|praktek
prakteknya|praktekna
private|pribadi
pribadi|pribadi
pribumi|pribumi
produk|produk
produksi|produksi
produksinya|produksina
produsen|produsen
profesional|profesional
program|program
programna|programna
promosi|promosi
provinsi|propinsi
prosedur|prosedur
proses|proses
penangkapan|proses newak
presiden|presiden
pelaminan|puade
berpuasa|puasa
pelihara|pulasara
pulas|pules
polisi|pulisi
politik|pulitik
politiknya|pulitikna
politisi|pulitisi
pulau|pulo
puluh|puluh
puluhan|puluhan
lunas|punah
selesaikan|pungkaskeun
unggul|punjul
permisi|punten
puntir|puntir
pimpinan|pupuhu
ketua|pupuhu
pemimpinnya|pupuhuna
purnawirawan|purnawirawan
pusat|puseur
ibu kota|puseur dayeuh
pustaka|pustaka
literatur|pustaka
putar|puter
peri|puteri
putra|putra
putuskan|putuskeun
pudar|peang
bisu|pego
terimalah|pek tarima
peluru|pelor
pincang|pengkor
penyok|penyon
per|per
perak|perak
pirang|perang
periode|periode
saku|pesak
pisau|peso
pistol|pestol
sipit|petet
berterbangan|rabeng
agak|rada
rakyat|rahayat
kekayaan|rajakaya
berdatangan|rajol
raksasa|raksasa
ramadhan|ramadan
web|ramat
berjuntai|rambay
berambut|rambutan
jari|ramo
serempak|rampak
rakus|rampus
rame|rame
rawa|ranca
cakap|rancage
janda|randa
tegang|rangkeng
rangkap|rangkep
rangkul|rangkul
rangkuman|rangkuman
rangsang|rangsang
renyah|rangu
tegang|ranteng
rapat|rapet
rapi|rapih
jaringan|raramat
terhuyung-huyung|rarampeolan
rancangan|rarancang
rancangannya|rarancangna
sisipan|rarangken
imbuhan|rarangken
perasaan|rarasaan
kabar-berita|raratan
rasa|rasa
rasakan|rasakeun
rasanya|rasana
rata|rata
ratu|ratu
ratus|ratus
raya|raya
rabu|rebo
simak|regep
tenggak|regot
akun|rekening
seringkali|remen oge
rencana|rencana
retak|rengat
republik|republik
sembunyi-sembunyi|rerencepan
diam-diam|rerencepan
suka|resep
menyenangi|resep kana
resmi|resmi
buram|reueuk
bangga|reueus
bangganya|reueusna
dahak|reuhak
beserta|reujeung
erat|reukeut
nyamuk|reungit
istirahat|reureuh
diam-diam|reureunceupan
kaget|reuwas
ringsek|rikes
detail|rinci
rayap|rinyuh
sakit-sakitan|ririwit
ris|ris
kumpul|riung
sibuk|riweuh
berubah|robah
ruangan|rohangan
dukung|rojong
rokok|roko
rokoknya|rokona
luar biasa|rongkah
tingkatkan|ronjatkeun
rasul|rosul
lebar|rubak
roboh|rubuh
rugi|rugi
kerugian|rugi
membara|ruhay
rujukan|rujukan
permata|rukmi
rusak|ruksak
rukun|rukun
berkeluh-kesah|rumahuh
remaja|rumaja
rumpun|rungkun
sampah|runtah
tumbang|runtuh
berurutan|runtuy
rangkaian|runtuyan
beragam|rupa-rupa
aneka|rupa-rupa
rahasia|rusiah
rutinnya|rutinna
banyak|rea
ribu|rebu
ribuan|rebuan
redaksi|redaksi
referensi|referensi
ranting|regang
hendak|rek
rekaman|rekaman
rektor|rektor
remah|remeh
teman|rencang
usai|rengse
selesai|rengse
replika|replika
bergerigi|reregean
residen|residen
uap|saab
senilai|saajen
searah|saarah
sebab|sabab
beberapa|sababaraha
berkali-kali|sababaraha-kali
sebabnya|sababna
bada|sabada
sebaliknya|sabalikna
sepulang|sabalikna
setiap|saban
sepadan|sabanding
sebangsa|sabangsa
sabar|sabar
seberapa|sabaraha
berapa|sabaraha
leluasa|sabarae
sebatang|sabatang
sebelas|sabelas
sebetulnya|sabenerna
sebenernya|sabenerna
sebenarnya|sabenerna
ketika|sabot
sebulan|sabulan
sehabis|sabeak
secangkir|sacangkir
secara|sacara
bunyi|sada
sadar|sadar
tersedia|sadia
sedikit|saeutik
sedikitnya|saeutikna
minimal|saeutikna
segala|sagala
berbagai|sagala rupa
secepatnya|sagancangna
laut|sagara
sebesar|sagede
sebesar-besarnya|sagede-gedena
segelas|sagelas
segi|sagi
siapa|saha
siapapun|saha oge
siapakah|saha tea
seharga|saharga
paling tidak|sahenteuna
setidaknya|sahenteuna
setidak-tidaknya|sahenteuna
serumah|saimah
seimbang|saimbang
selain|sajaba
selain itu|sajaba ti eta
sebagainya|sajabana
sejajar|sajajar
sejarah|sajarah
sejarahnya|sajarahna
sejati|sajati
sejauh|sajauh
seluas-luasnya|sajembar-jembarna
sesaat|sajongjonan
sejumlah|sajumlah
sejuta|sajuta
segenap|sakabeh
keseluruhan|sakabeh
semaunya|sakahayangna
sekali|sakali
sesekali|sakali-kali
sekalian|sakalian
sekaligus|sakaligus
sekampung|sakampung
sepengetahuan|sakanyaho
terkadang|sakapeung
kadang-kadang|sakapeung
kadang|sakapeung
sekarat|sakarat
sebentar|sakeudeung
sebentar|sakeudeung
saking|saking
sekian|sakitu
sedemikian|sakitu
sekolah|sakola
sekolahnya|sakolana
sekilas|sakolebat
sekotamadya|sakotamadya
sekejap|sakoteap
saksi|saksi
saksikan|saksian
semestinya|sakuduna
seharusnya|sakuduna
mestinya|sakuduna
seantero|sakuliah
sebagaimana|sakumaha
seluruh|sakumna
sekurang-kurangnya|sakurang-kurangna
sekitarnya|sakurilingna
salah|salah
salah satu|salah sahiji
salah satunya|salah sahijina
salahnya|salahna
suami|salaki
suamiku|salaki kuring
suami-istri|salaki-pamajikan
suaminya|salakina
selaku|salaku
salam|salam
selamat|salamet
selamatkan|salametkeun
sembilan|salapan
bersembilan|salapanan
selasa|salasa
selamanya|salawasna
seluas|salega
setanah|salemah
khawatir|salempang
selengkapnya|salengkepna
tertawa-tawa|saleuseurian
sekecil|saleutik
selebihnya|saleuwihna
selama|salila
salinan|salinan
selisik|salisik
sebanyak|saloba
santai|salse
setinggi|saluhur
atasannya|saluhureunana
sejalan|saluyu
gerhana|samagaha
tikar|samak
bumbu|samara
samawi|samawi
sembarang|sambarang
utang|sambetan
hubungkan|sambungkeun
sambungnya|sambungna
sementara|samentara
semilyar|samilyar
semiliar|samilyar
sepekan|saminggu
sekongkol|samiuk
singkong|sampeu
samper|sampeur
samperin|sampeurkeun
sempurna|sampurna
sebelum|samemeh
sebelumnya|samemehna
walaupun|sanajan
meskipun|sanajan
kendati|sanajan
damping|sanding
sandera|sandra
setibanya|sanepina
belulang|sanggal
setelah|sanggeus
sanggul|sanggul
sanggup|sanggup
mampu|sanggup
hadapi|sanghareupan
sangka|sangka
supaya|sangkan
nasi|sangu
sepanjang|sapanjang
seperempat|saparapat
sepasang|sapasang
berhubungan intim|sapatemon
sepatu|sapatu
semalam|sapeuting
sapi|sapi
sepenuhnya|sapinuhna
sehari-hari|sapopoe
sehari|sapoe
seharian|sapoe jeput
semenjak|saprak
sejak|saprak
sabtu|saptu
setuju|sapuk
sepakat|sapuk
sepuluh|sapuluh
bersepuluh|sapuluhan
sepeda|sapedah
seragam|saragam
serakah|sarakah
seramai|sarame
matahari|sarangenge
syarat|sarat
seratus|saratus
serikat|sarikat
setara|sarimbag
sombong-sombong|sarombong
serta|sarta
dan|sarta
sama|sarua
serupa|sarupa
semacam|sarupaning
bersoraklah|sarurak
serba|sarwa
tidur|sare
syariat|sareat
syariah|sareat
seribu|sarebu
seusai|sarengse
sesama|sasama
sesamanya|sasamana
kesamaan|sasaruaan
kesamaannya|sasaruanana
sastra|sastra
sekuat-kuatnya|satakerna
setapak|satapak
sekeras|satarik
setahun|sataun
setempat|satempat
setengah|satengah
seterusnya|saterusna
selanjutnya|saterusna
lantas|saterusna
kemudian|saterusna
berikutnya|saterusna
setia|satia
setianya|satiana
hewan|sato
binatang|sato
satria|satria
setrilyun|satrilyun
setriliun|satrilyun
musuh|satru
sesudahnya|satutasna
sate|sate
sekedar|saukur
sekadar|saukur
hanyalah|saukur
seumur|saumur
saung|saung
serangkaian|sauntuyan
seorang|saurang
sepatutnya|sawajarna
sepantasnya|sawajarna
lazim|sawajarna
sewaktu|sawaktu
semasa|sawaktu
sewaktu-waktu|sawaktu-waktu
diskusi|sawala
berdiskusi|sawala
sebagian|sawareh
beberapa|sawatara
dewasa|sawawa
seember|saember
sesungguhnya|saestuna
sebal|sebel
sebalnya|sebelna
ciprat|sebret
sebut|sebut
sebutan|sebutan
sedangkan|sedengkeun
adapun|sedengkeun
sedap|sedep
sedot|sedot
segar|seger
isak|segruk
sekrup|sekrup
sempat|sempet
seni|seni
senin|senen
pucat|sepa
sepi|sepi
serang|serang
surat kabar|serat kabar
serbu|serbu
sersan|sersan
sesak|sesek
puas|seubeuh
mual|seueul
tajam|seukeut
api|seuneu
berapi|seuneuan
wangi|seungit
harum|seungit
sirih|seureuh
tertawa|seuri
wewangian|seuseungitan
shaum|siam
siap|siap
siapkan|siapkeun
sidang|sidang
persidangan|sidang
takut|sieun
ketakutan|sieun
taring|sihung
biji|siki
silih|silih
saling|silih
silinder|silinder
simbol|simbol
selimut|simbut
belalang|simeut
simpan|simpen
dipersilakan|sina
berkesinambungan|sinambungan
tumben|sinarieun
sindiran|sindiran
percayalah|sing percaya
barangsiapa|sing saha
barang siapa|sing saha
pintar|singer
singkat|singget
singkatan|singgetan
sentil|sintreuk
sifat|sipat
karakter|sipat
sifatnya|sipatna
sipil|sipil
sepuh|sipuh
kepala|sirah
kepalanya|sirahna
laron|siraru
semut|sireum
penis|sirit
tunas|sirung
sisi|sisi
pinggir|sisi
cegukan|sisidueun
sisik|sisit
sistem|sistem
sistematis|sistematis
siswa|siswa
siuk|siuk
skala|skala
skandal|skandal
slogan|slogan
slogannya|sloganna
soal|soal
soalnya|soalna
angsa|soang
senantiasa|sok
selalu|sok
sholat|solat
shalat|solat
salat|solat
tentara|soldadu
serdadu|soldadu
prajurit|soldadu
selubung|solobong
peleset|soledat
ramah|someah
bersahabat|someah
sombong|songong
rindu|sono
merindukan|sono kana
sopan|sopan
suara|sora
suaranya|sorana
sendirian|sorangan
sendiri|sorangan
petang|sore
sore|sore
sosial|sosial
sobek|soeh
stadion|stadion
stamina|stamina
standar|standar
statusnya|statusna
studi|studi
janji|subaya
shubuh|subuh
suci|suci
barangkali|sugan
sukarelawan|sukarelawan
sukses|sukses
kaki|suku
kakinya|sukuna
selundupan|sulundupan
semangat|sumanget
semangatnya|sumangetna
silakan|sumangga
apalagi|sumawona
sumbang|sumbang
sumbangan|sumbangan
tersebar|sumebar
edarkan|sumebarken
tersebarnya|sumebarna
penyebaran|sumebarna
berserah|sumerah
bersujud|sumujud
sumur|sumur
mulut|sungut
mulutnya|sungutna
sopir|supir
pengemudi|supir
suplemen|suplemen
surat|surat
suratnya|suratna
terbenam|surup
email|surelek
e-mail|surelek
susu|susu
mudah-mudahan|susuganan
susunan|susunan
jamur|suweng
lain|sejen
lainnya|sejenna
seks|seks
sel|sel
selular|selular
tamu|semah
senat|senat
senator|senator
sendok|sendok
sensitif|sensitip
sentimeter|sentimeter
sepak|sepak
september|september
sawah|serang
seri|seri
sertifikat|sertipikat
seremonial|seremonial
cadangan|serep
sisa|sesa
sisanya|sesana
masing|sewang
seng|seeng
taat|taat
tablig|tableg
bertabrakan|tabrakan
tabiat|tabeat
belum|tacan
tadi|tadi
tadinya|tadina
tagihan|tagihan
nah|tah
tahan|tahan
bertahan|tahan
penahan|tahanan
hambatan|tahanan
tendangan|tajongan
takbiran|takbiran
takar|taker
tangkis|takis
pundak|taktak
tradisi|talari
pesan|talatah
teliti|taliti
bertekuk lutut|taluk
tembaga|tambaga
tambahan|tambahan
tambahnya|tambahna
tolak|tampik
penolakan|tampikan
tenaga|tanaga
tanda|tanda
penanda|tanda
bertanding|tanding
tanduk|tanduk
tampung|tande
tanah|taneuh
tanahnya|taneuhna
tangga|tangga
tanggal|tanggal
tanggung|tanggung
bertanggung|tanggung
bertanggungjawab|tanggung jawab
pohon|tangkal
tangsi|tangsi
tantangan|tangtangan
tentu|tangtu
tani|tani
tanpa|tanpa
tanya|tanya
jejak|tapak
tetapi|tapi
tapi|tapi
namun|tapi
akan tetapi|tapi
sigap|tapis
terjang|tarajang
kening|tarang
teliti|tarapti
terasi|tarasi
terigu|tarigu
terima|tarima
terjemah|tarjamah
terjemahan|tarjamahan
berkelahi|tarung
kacamata|tasma
tata|tata
bercocok-tanam|tataman
terapi|tatamba
tatanan|tatanan
tetangga|tatangga
pepohonan|tatangkalan
pertanian|tatanen
terluka|tatu
luka|tatu
cedera|tatu
luka berat|tatu parna
tauhid|tauhid
tahun baru|taun anyar
tahun lalu|taun ka tukang
tahunan|taunan
taurat|taurat
tawaran|tawaran
tawakal|tawekal
tegap|tegep
tegar|teger
tegas|teges
tegaskan|tegeskeun
tegasnya|tegesna
teguh|teguh
terlambat|telat
telat|telat
semena-mena|telenges
kejam|telenges
telpon|telepon
telepon|telepon
tempat|tempat
tempatnya|tempatna
letaknya|tempatna
pandang|tempo
lihat|tempo
tenang|tenang
tengah|tengah
menengah|tengahan
damai|tengtrem
teras|tepas
jumpa|tepung
terjun|terjun
terus|terus
lanjutnya|terusna
pemandangan|tetempoan
pandangan|tetempoan
tetap|tetep
tak|teu
nggak|teu
gak|teu
ilegal|teu legal
tidak cukup|teu mahi
mengabaikan|teu malire
menyangkal|teu ngaku
tidaklah|teu pisan-pisan
ketidakseimbangan|teu saimbangna
bertentangan|teu saluyu
keras|teuas
entah|teuing
entahlah|teuing atuh
mandiri|teuneung
pukulan|teunggeulan
dari|ti
dari-nya|ti Mantenna
terguling|tiguling
tiang|tihang
terdahulu|tiheula
dulu|tiheula
silam|tiheula
dingin|tiis
terjengkang|tijengkang
tenggelam|tikerelep
tenggorokan|tikoro
terpeleset|tikosewad
sakit-sakitan|tiktikbrek
tiga|tilu
bertiga|tiluan
timbangan|timbangan
timbulnya|timbulna
cemburu|timburu
temuan|timuan
atas segala|tina sagala
tentunya|tinangtu
tinggal|tinggal
tertinggal|tinggaleun
ketinggalan|tinggaleun
tinggalkan|tinggalkeun
tingkah|tingkah
tingkat|tingkat
taraf|tingkat
kepung|tingker
ketimbang|tinimbang
pertimbangan|tinimbangan
tenun|tinun
seduh|tinyuh
tipe|tipe
tipu|tipu
tepung|tipung
dinginnya|tirisna
suruh|titah
titik|titik
peninggalan|titilar
amati|titenan
kerudung|tiung
tiupan|tiupan
tewas|tiwas
tewaskan|tiwaskeun
kematian|tiwasna
tebu|tiwu
senggol|todel
blak-blakan|togmol
toko|toko
toleransi|toleransi
jangankan|tong boro
punggung|tonggong
tonjok|tonjok
tonjol|tonjol
terobos|torobos
teropong|toropong
terowongan|torowongan
tuli|torek
total|total
sentuh|toel
cinta|tresna
truk|treuk
trinitas|trinitas
tebang|tuar
tugu|tugu
tujuan|tujuan
tujuannya|tujuanana
tujuh|tujuh
bertujuh|tujuhan
belakang|tukang
pegulat|tukang gulat
belakangnya|tukangeunana
tuker|tukeur
tukar|tukeur
tulang|tulang
telaten|tulaten
tulis|tulis
tulisan|tulisan
tuliskan|tuliskeun
tolong|tulung
lalu|tuluy
lanjut|tuluy
tombak|tumbak
simpul|tumbu
pranala|tumbu
menimpa|tumiba
mendera|tumiba
tumpang|tumpang
tumpas|tumpes
tumbuh|tumuwuh
tumbuhnya|tumuwuhna
mengantuk|tunduh
tunggal|tunggal
sengsara|tunggara
tunggu|tunggu
tertunduk|tungkul
bungkus|tungkus
ujung|tungtung
ujungnya|tungtungna
tuntut|tungtut
tuntutan|tungtutan
tunjang|tunjang
tunjuk|tunjuk
tunjukkan|tunjukkeun
pelancong|turis
turun|turun
turunan|turunan
keturunan|turunan
menurunnya|turunna
turut|turut
ikuti|turutan
tandan|turuy
totol|tutul
kendaraan|tutumpakan
tutup|tutup
tumbuh-tumbuhan|tutuwuhan
lutut|tuur
tiris|tuus
cari|teang
plin-plan|tegtog
teh|teh
teknik|teknik
teknis|teknis
teknologi|teknologi
nyata|tela
televisi|televisi
tema|tema
tembakan|tembakan
jawabnya|tembalna
tempo|tempo
teorinya|teorina
nular|tepa
menular|tepa
teroris|teroris
tiri|tere
ternyata|tetela
obat|ubar
keliling|ubeng
kucing|ucing
lepas|ucul
kejar|udag
target|udagan
patungan|udunan
iuran|udunan
tambat|uger
ujub|ujub
tiba-tiba|ujug-ujug
tanjung|ujung
ukuran|ukuran
berukuran|ukuranana
janganlah|ulah
jangan|ulah
main|ulin
maen|ulin
bermain|ulin
umat|umat
umrah|umroh
umum|umum
pada umumnya|umumna
umumnya|umumna
usia|umur
umur|umur
berusia|umurna
tiap|unggal
setiap kali|unggal
mengangguk|unggeuk
gerak|unggut
ungkap|ungkab
keunikan|unikna
unit|unit
universitas|universitas
unsur|unsur
untung|untung
untungnya|untungna
upacara|upacara
umpama|upama
umpamanya|upamana
asyik|uplek
kita|urang
huru-hara|uru-ara
longsor|urug
urusan|urusan
mantan|urut
bekas|urut
usaha|usaha
upaya|usaha
berusaha|usaha
bergerak|usik
usul|usul
musim|usum
muntah|utah
muntahnya|utahna
utama|utama
utamanya|utamana
terutama|utamana
akal|uteuk
utusan|utusan
utusannya|utusanna
bervariasi|variatif
video|video
versi|versi
baja|waja
wajar|wajar
wajib|wajib
wakil-wakilnya|wakil-wakilna
kurun waktu|waktu
waktu|waktu
saat|waktu
waktunya|waktuna
saatnya|waktuna
belikat|walikat
belerang|walirang
sungai|walungan
sengsara|walurat
ragam|wanda
bentuk|wangun
bangunan|wangunan
citra|wangwangan
berani|wani
wanita|wanoja
mondar-mandir|wara-wiri
ongkos|waragad
biaya|waragad
waras|waras
kenyang|wareg
warga|warga
warganegara|warganagara
warnanya|warnana
tahun|warsih
berita|warta
wartawan|wartawan
jurnalis|wartawan
warung|warung
watak|watek
batas|wates
batasan|watesan
kasihan|watir
bohong-bohongan|wawadukan
wakil|wawakil
perwakilan|wawakil
wawancara|wawancara
penjelasan|wawaran
jelaskan|wawarkeun
kenal|wawuh
waktu|wayah
saja|wae
aja|wae
bedak|wedak
belasan|welasan
rentang|wengkuan
lingkup|wengkuan
cakupan|wengkuan
bening|wening
rawan|werit
tahu|weruh
perbaharui|weuteuhan
wilayah|wewengkon
ranah|wewengkon
kawasan|wewengkon
daerah|wewengkon
area|wewengkon
langit|wiati
bidang|widang
kerai|wide
bijaksana|wijaksana
bijan|wijen
selamat jalan|wilujeng angkat
irama|wirahma
firasat|wirasat
pertimbangan|wiwaha
wujudnya|wujudna
belaka|wungkul
ungu|wungu
bubungan|wuwungan
timur|wetan
yahudi|yahudi
yakin|yakin
yatim|yatim
yayasan|yayasan
nih|yeuh
ketam|yuyu
bahwa|yen
zabur|zabur
zakat|zakat
jelas|eces
jelaskan|eceskeun
edisi|edisi
efek|efek
eh|eh
ejaan|ejahan
ejaannya|ejahanana
ejektor|ejektor
alasan|ekol
ekonom|ekonom
ekonomi|ekonomi
ekspor|ekspor
eksportir|eksportir
ekstradisi|ekstradisi
elevasinya|elevasina
elit|elit
ilmu|elmu
kalah|eleh
elektronik|elektronik
elektronika|elektronika
pengumuman|embaran
tambah|emboh
imbuh|emboh
imbuhnya|embohna
emosional|emosional
emper|emper
cair|encer
indah|endah
elok|endah
indahnya|endahna
bebek|entog
episode|episodeu
iptek|eptek
malu|era
eskalator|eskalator
sungguh|estuning
itu|eta
itulah|eta pisan
itu adalah|eta teh
etik|etik
etika|etika